type octile-corner
height 65
width 65
map
00000000000000000000000000000000000000000000000000000000000000000
00000020000000000000000000000000000000000000000000000000000000000
00000002000000000000000000000000000000000010000000022200000000000
00000022000000000000000011100000010001001111002002011000000000000
00002222000000000000220200101100100011012222110110111110000100000
20222222200001022020000222211201111112222222221222112220221000000
00020222001222222222200022222222222222222222222222222222211000000
20200002002222222222222222222222222222222222222222222222211110000
22220200001222222222222222222222222222222222222222222222222110000
22222000000122222222222222222222222222222222222222222222222210000
20220000001122222222222222222222222222222222222222222222222100000
00002000011222222222222222222222222222222222222222222222222110000
00000000112222222222222222222222222222222222222222222222222120000
00002011122222222222222222222222222222222222222222222222222220000
00000001122222222222222222222222222222222222222222222222222210000
00000011222222222222222222222222222222222222222222222222222200000
00000011222222222222222222222222222222222222222222222222222200000
00220212222222222222222222222222222222222222222222222222222000002
00002222222222222222222222222222222222222222222222222222220002022
00000222222222222222222222222222222222222222222222222222220000222
00202222222222222222222222222222222222222222222222222222220000222
00022222222222222222222222222222222222222222222222222222220000200
00022222222222222222222222222222222222222222222222222222200000020
00022222222222222222222222222222222222222222222222222221000000002
00002222222222222222222222222222222222222222222222222221100000022
00022222222222222222222222222222222222222222222222222222222000022
00002222222222222222222222222222222222222222222222222222222000000
00022222222222222222222222222222222222222222222222222222222200000
00022222222222222222222222222222222222222222222222222222222200000
00202222222222222222222222222222222222222222222222222222222220000
00202222222222222222222222222222222222222222222222222222222220000
02222222222222222222222222222222222222222222222222222222222222000
00220222222222222222222222222222222222222222222222222222222200000
00002222222222222222222222222222222222222222222222222222222220000
00002222222222222222222222222222222222222222222222222222222200202
00202222222222222222222222222222222222222222222222222222222200000
02202222222222222222222222222222222222222222222222222222222200000
02000222222222222222222222222222222222222222222222222222220000000
02200222222222222222222222222222222222222222222222222222210000022
00010022222222222222222222222222222222222222222222222221110000022
00110222222222222222222222222222222222222222222222222221110000022
00022222222222222222222222222222222222222222222222222221100000022
00222222222222222222222222222222222222222222222222222221100000002
00002222222222222222222222222222222222222222222222222222110100002
00002222222222222222222222222222222222222222222222222222211100000
00022222222222222222222222222222222222222222222222222222222110020
00000222222222222222222222222222222222222222222222222222222200000
00202222222222222222222222222222222222222222222222222222222200000
00200222222222222222222222222222222222222222222222222222222200000
00202222222222222222222222222222222222222222222222222222222220000
00022222222222222222222222222222222222222222222222222222222210000
00022222222222222222222222222222222222222222222222222222222110000
20002222222222222222222222222222222222222222222222222222222110000
20022222222222222222222222222222222222222222222222222222222210100
22000222222222222222222222222222222222222222222222222222222221000
22002222222222222222222222222222222222222222222222222222222210000
20022222222222222222222222222222222222222222222222222222222210100
00222222222222221111122222222222222222222222222222222222222111200
00222222222211211000122222222222222222222222222222222222222212200
00020222222110000000022222222222222222222222222222222222222222000
00000022222100000101222222222222222112222222222222222222222221000
00002222222200001001022220222222221112222211222222222222222121100
00002000220000000000000000012022011011222112222222222221221111000
00000000000000000000000000200010011000022000002202200000022101000
00000000000000000000000000000000000000000000000000000000000000000
WWWWWWWWWWWWWWWWWWWWWWWWWWWWWWWWWWWWWWWWWWWWWWWWWWWWWWWWWWWWWWWWW
OOOOOOOOOOOOOOOOOOOOOOOOOOOOOOOOOOOOOOOOOOOOOOOOOOOOOOOOOOOOOOOOW
OOOOOOOOOOOOOOOOOOOOOOOOOOOOOOOOOOOOOOOOOOOOOOOOOOOOOOOOOOOOOOOOW
OOOOOOOOOOOOOOOOOOOOOOOOOOOOOOOOOOOOOOOOOOOOOOOOOOOOOOOOOOOOOOOOW
OOOOOOOOOOOOOOOOOOOOOOOOOOOOOOOOOOOOOOOOOOOOOOOOOOOOOOOOOOOOOOOOW
OOOOOOOOOOOOOOOOOOOOOOOOOOOOOOOOOOOOOOOOOOOOOOOOOOOOOOOOOOOOOOOOW
OOOOOOOOOOOOOOOOOOOOOOOOTTOOOOOOOOOOOOOTTOTTTOOOOOOOOTOOOOOOOOOOW
OOOOOOOOOOOTOTTTTOTOOOOOOOTTOTOTOTTOTTTOTTOTOTOTTOTTTOTOOOOOOOOOW
OOOOOOOOOOOOTTTOTTOOTTOOOTOTTTTTTTOTOOOOOTTOTOTOTTOTTTOOOOOOOOOOW
OOOOOOWWWWWSTGTTGTTTTTTTTTTTTTTTGGTTGTTTGTTTTTTTTTTTGTTTTGOOOOOOW
OOOOOOWWWWSSGTTGGGGTTTTTTTTTTTTGTTTTGGGGGTTTTTTTTTTTTTTTTTOOOOOOW
OOOOOOWWWSSGGTTGGGGGGTTTTTTTTTTTTTTTGGGGGTTTTTTTTTTTTTTTTTOOOOOOW
OOOOOOWWSSGGGTTGGGGGTTTTTGGTTGGTTTTTGGGGGGTTTTTTTTTGGGGTTTOOOOOOW
OOOOOOSSSGGGTTTGGGGGGTTGGGGGGGGTTTTTGGGGGGTTTTTTGGGGGGGTTGOOOOOOW
OOOOOOWSSGGGTTTGGGGGGGGGGGGGGGGGGGTTTGGGGTTTTGGGGGGGGGGTTTOOOOOOW
OOOOOOSSGGGGTTGGGGGGGGGGGGGGGGGGGGTTTTGGTTTTGGGGGGGGGGGTTTTOOOOOW
OOOOOOSSGGGGGGGGGGGGGGGGGGGGGGGGGGGTTTTTTTGGGGGGGGGGGGGGTTTOOOOOW
OOOOOOSGGGGGGGGGGGGGGGGGGGGGGGGGGGGGTTTTTTGGGGGGGGGGGGGGTTOOOOOOG
OOOOOOGGGTGGGGGGGGGGGGGGGGGGGGGGGGGGGTTTGGGGGGGGGGGGGGGTTGOOOOOOG
OOOOOOTTTTTGGGGGGGGGGGGGGGGGGGGGGGGGGTTTGGGGGGGGGGGGGGGTTGOOOOOOG
OOOOOTGTTTTGGGGGGGGGGGGGGGTTGGGGGGGTTTTGGGGGGGGGGGGGGGGTTGOOOOOOG
OOOOOTTTTTGTGGGGGGGGGGGGGTTTGGGGGGGTTTGGGGGGGGGGGGGGGGGGTGOOOOOOW
OOOOTTTTTTTTGGGGGGGGGGGGGGTTTGGGGTTTTGGGGGGGGGGGGGGGGGGGGWOOOOOOW
OOOOTTTTGGTTTGGGGGGGGGGGTTTGGGGGGTTTGGGGGGGGGGGGGGGGGGGGSWOOOOOOG
OOOOTTGGGGTTTGGGGGGGGGGTTTTGGGGGTTTGGGGGGGTTGGGGGGGGGGGGGWOOOOOOG
OOOOOTGGGGGTTTGGGGGGGGTTTGGGGGGTTTGGGGGGTTTTGGGGGGGGGGGGGGOOOOOOG
OOOOOTGGGGGTTTGGGGGGGGGTTGGGGGGGTTTGGGGGTTTGGGGGGGGGGGGTTTOOOOOOW
OOOOTTGGGGGTTTGGGGGGGGGGGGGGGGGTTTGGGGGTTTTGGGGGGGGGGGTTTTOOOOOOW
OOOOTTGGGGGTTTTTGGGGGGGGGGGGGGTTTGGGGGGTTTGGGGGGGGGTTTTTTTTOOOOOW
OOOOOTGGGGGTTTTTGGGGGGGGGGGGGGGTTGGGGGGGTGGGGGGGGGGTTTTTTGOOOOOOW
OOOOTOGGGGTTTTTTTTTGGGGGGGGGGGGTTTGGGGGGGGGGGGGGGGTTTTGGGGOTOOOOW
OOOOTOTTTTTTTGTTTTTTTTGGGGGGGGTTTGGGGGGGGGGGGGGGTTTTTTGGGGOTOOOOW
OOOOOTGTTTTTGGGTTTTTTTTGGGGGGGGTTGGGGGGGGGGGGTTTTTTTTTGGGGTOOOOOW
OOOOOOTTTTTGGGGGGGTTTTTGGGGGGGTTTTTGGGGGGGGGGTTTTTTTTTGGGGOOOOOOW
OOOOOTGTTTGGGGGGGGGGGTTTTGGGGTTTTTTTGGGGGGGGTTTTGGGTTTGGGGTOOOOOG
OOOOOOTTTGGGGGGGGGGGGTTTGTGGTTTTTTTTTTTGGGGTTTTGGGGTTTTTGTOOOOOOW
OOOOTTGTTTGGGGGGGGGGGGTTTTTTTTTTTTTTTTTTTTTTTTGGGGGGTTTTTTOOOOOOW
OOOOOOTTTGGGGGGGGGGGGGTTTTTTGTTTTTTTTTTTTTTTTGGGGGGGGTTTTGOOOOOOW
OOOOOOGTTTGGGGGGGGGGGGGGTTTTTTTGGGGGTTTTTTTGGGGGGGGGGGGTGGOOOOOOG
OOOOOOTTTTGGGGGGGGGGGGGGGTTTTTTGGGGGGTTTTTGGGGGGGGGGGGGGGSOOOOOOG
OOOOOOGTTTTGGGGGGGTTGGGGGGGTTTTGGGGGGTTTTGGGGGGGGGGGGGGSSSOOOOOOG
OOOOOTTTTTTGGGGGGTTTGGGGGGGTTTTGGGGGTTTTGGGGGGGGGGGGGGGSSWOOOOOOG
OOOOTTGTTTTGGGGGGGTTTGGGGGGGTTTGGGGGGTTTGGGGGGTGGGGGGGGSSWOOOOOOG
OOOOTOTTTTGGGGGGGGTTTGGGGGGGTTTTTTTTTTTGGGGGGGTTGGGGGGGGSSOOOOOOG
OOOOTTGTTTGGGGGGGGGTTTTGGGGGTTTTTTTTTTTGGGGGTTTTGGGGGGGGGSOOOOOOW
OOOOOTTTTGGGGGGGGGGGTTTGGGGGTTTTTTTTTTGGGGTGTTTGGGGGGGGGGGOOOOOOW
OOOOOOGTTGGGGGGGGGGGGTTGGGGGGTTTTTTTGGGGGTTTTGGGGGGGGGGGTTOOOOOOW
OOOOOTTTTGGGGGGGGGGGGGGGGGGGGTTTTGGGGGGGGTTTTGGGGGGGGGGTTTTOOOOOW
OOOOOOGTTGGGGGGGGGGGGGGGGGGGTTTTGGGGGGGGGGGGGGGGGGGGGGGGTTTOOOOOW
OOOOOTTGGGGGGGGGGGGGGGGGGGGTTTTGGGGGGGGGGGGGGGGGGGGGGGGTTGTOOOOOW
OOOOOTTGGGGGGGGGGGGGGGGGGGGGTTTGGGGGGGGGGGGGGGGGGGGGGGGTTTOOOOOOW
OOOOTOGGGGGGGGGGGGGGGGGGGGGTTTGGGGGGGGGGGGGGGGGGGGGGGGGTTTOOOOOOW
OOOOOTGGGGGGGGGGGGGGGGGGGGGTTTTGGGGGGGGGGGGGGGGGGGGGGGGGTTOOOOOOW
OOOOOTTGGGGGGTGGGGGGGGGGGTTTTTGGGGGGGGGGGGGGGGGGGGGGGGGTTTOOOOOOW
OOOOOTGGGGGGTTTTTGGGGGGGTTTTTTTTTGGGGGGGGGGGGGGGGGGGGGGGTTTOOOOOW
OOOOOTGGGGGGTTGTGTGGGGGTTTTTTTTTTTTGGGGGGGGGGGGGGGGGGGGGTTTOOOOOW
OOOOTTTGGTGTTTTGTGGGGGTTTTGGGGGTTTTTTGGGGGTGTTGGGGGGGGGGTTOOOOOOW
OOOOTTGTTTTTTGGGGSSSSGTTTTGGGGGGTTTTTTGGTTTGTGTTGGGGGGGGTTOOOOOOW
OOOTOOTTTTTGGGGGSWWWSGTTTTGGGGGGTTTTTTTTTTTTTTTTTTGGGGGGTTOOOOOOW
OOOOOTTTTTGGGWWWWWWWWGTTTTGGGGGGTTTTTTTTTTTTTTTTTTTGGGGGTTTOOOOOW
OOOOOOTTTGGSWWWWWSWSGTTTTTGGGGGGTGGGGTTTTTTTTTTTTTTTTTTTTTTOOOOOW
OOOOOOOOTOOOOOOOOOOOOOTTOOOOOTOOOOOOOOTTOOOOOTTTOTOTOTOTOTOOOOOOW
OOOOOOOOOOOOOOOOOOOOOOOOOOOOOOTOOOOOOOOOOOOOOOTOTOTOTOOOOOOOOOOOW
OOOOOOOOOOOOOOOOOOOOOOOOOOOOOOOOOOOOOOOTOOOOOOOOOOOOOOOOOOOOOOOOW
OOOOOOOOOOOOOOOOOOOOOOOOOOOOOOOOOOOOOOOOOOOOOOOOOOOOOOOOOOOOOOOOW
