type octile-corner
height 97
width 97
map
5555555555555555555555555555555555555555555555555555555555555555555555555555555555555555555555555
5555555555555555555555555555555555555555555555555555555555555555555555555555555555555555555555555
5555555555555555555555555555555555555555555555555555555555555555555555555555555555555555555555555
5555555555555555555555555555555555555555555555555555555555555555555555555555555555555555555555555
5555555555555555555555555555555555555555555555555555555555555555555555555555555555555555555555555
5555555555555555555555555555555555555555555555555555555555555555555555555555555555555555555555555
5555555555555555555555555555555555555555555555555555555555555555555555555555555555555555555555555
5555555555555555555555555555555555555555555555555555555555555555555555555555555555555555555555555
5555555555555555555555555555555555555555555555555555555555555555555555555555555555555555555555555
5555555555555555555555555555555555555555555555555555555555555555555555555555555555555555555555555
5555555555555555555555555555555555555555555555555555555555555555555555555555555555555555555555555
5555555555555555555555555555555555555555555555555555555555555555555555555555555555555555555555555
5555555555555555555555555555555555555555555555555555555555555555555555555555555555555555555555555
5555555555555555555555555555555555555555555555555555555555555555555555555555555555555555555555555
5555555555555555555555555555555555555555555555555555555555555555555555555555555555555555555555555
5555555555555555555555555554555555555555555555555555555555555555555555555555555555555555555555555
5555555555555555555555554554444555555555555555555555555555555554454445555555555555555555555555555
5555555555555555554445555444424444555555555555545533555555555443444244444444444555555555555555555
5555555555555555544244444422222224444455555555533333345555544444342222442224424455555555555555555
5555555555555555542224422222222222424445455544333333333544443344422222222222222445555555555555555
5555555555555555542222222222222222222333445553333333333344443434222222222222222245555555555555555
5555555555555555544222222222222222222222334443333333333333223223322222222222222445555555555555555
5555555555555555554222222222222222222222224433333333333343222222222222222222222455555555555555555
5555555555555555554222222222222222222222223433333333333332222222222222222222222454555555555555555
5555555555555555444222222222222222222222224433333333333322222222222222222222223454555555555555555
5555555555555555542222222222222222222222223333333333333332222222222222222222222445555555555555555
5555555555555555542222222222222222222222222333333333333322222222222222222222222245555555555555555
5555555555555555542222222222222222222222222222333333333222222222222222222222222244555555555555555
5555555555555555544222222222222222222222222222333333332222222222222222222222222224555555555555555
5555555555555555554422222222222222222222222222222222222222222222222222222222222244555555555555555
5555555555555555544422222222222222222222222222222222222222222222222222222222222445555555555555555
5555555555555554442222222222222222222222222222222222222222222222222222222222244455555555555555555
5555555555555555422222222222222222222222222222222222222222222222222222222222245555555555555555555
5555555555555555442222222222222222222222222222222222222222222222222222222222345555555555555555555
5555555555555555544222222222222222222222222222222222222222222222222222222223445555555555555555555
5555555555555555554442222222222222222222222222222222222222222222222222222224455555555544444444444
5555555555555555555543322222222222222222222222222222222222222222223333333333355454455444444444444
5555555555555555555443333222222222222222222222222222222222222222233333333333334444444444444444444
5555555555555555555533333222222222222222222222222222222222222222333333333333334334434333333333333
5555555555555555555533333333333333322222222222222222222222222222333333333333333233322211111111111
5555555555555555555333333333333333333222222222222222222222222222233333333333332112210000000000000
5555555555555555555533333333333333333222222222222222222222222222223333333333311000000000000000000
5555555555555555555543333333333333333222222222222222222222222222223333333111110001011222222222222
5555555555555555555533333333333333322222222222222222222222222222223333331100000012223344444444444
5555555555555555555333333333333333222222222222222222222222212222233333332000010123444455555555555
5555555555555555553333333333333333222222222222222222222222210122233333332211012233455555555555555
5555555555555555553333333333333333222222222211111111111110100000113333333332223444455555555555555
5555555555555555553333333333333333332222222111111111111111000000013333333333344555555555555555555
5555555555555555553333333333333333333320022111111111111111000001113333333333355555555555555555555
5555555555555555555333333333333333333322000111111111111111020022233333333333335555555555555555555
5555555555555555555533333333333333332220000111111111111111222223333333333333333555555555555555555
4444444444454554454443333333333312321102011022222222222222222222333333333333333555555555555555555
4444444444444443444243333333333311110000022222222222222222222222233333333333333355555555555555555
3333333333333422222222233233333310000000222222222222222222222222233333333333333355555555555555555
2222222222212220020022111233333311000000222222222222222222222222233333333333333555555555555555555
1111111111100010000101110133333332200002222222222222222222222222333333333333335555555555555555555
0000000000000000012221321133333333222112222222222222222222222223333333333333355555555555555555555
0000000000000101012433333333333332222222222222222222222222222222333333333334455555555555555555555
1111111111122202223443333333333322222222222222222222222222222222233333333334444555555555555555555
3333333333334222344443333333333322222222222222222222222222222223333333333333355555555555555555555
4444444444444444444433333333333322222222222222222222222222222223333333333333355555555555555555555
5555555555545555445433333333333332222222222222222222222222222222233333333333334555555555555555555
5555555555555555554333333333333332222222222222222222222222222222233333333333334555555555555555555
5555555555555555555433333322222222222222222222222222222222222222223333333333345555555555555555555
5555555555555555555433322222222222222222222222222222222222222222223333333333455555555555555555555
5555555555555555555543222222222222222222222222222222222222222222222222222232444455555555555555555
5555555555555555555442222222222222222222222222222222222222222222222222222222222445555555555555555
5555555555555555555542222222222222222222222222222222222222222222222222222222222245555555555555555
5555555555555555554443222222222222222222222222222222222222222222222222222222222445555555555555555
5555555555555555555443222222222222222222222222222222222222222222222222222222222244555555555555555
5555555555555555554423222222222222222222222222222222222222222222222222222222222224455555555555555
5555555555555555544222222222222222222222222222222222222222222222222222222222222222455555555555555
5555555555555555542222222222222222222222222223333333322222222222222222222222222224455555555555555
5555555555555555542222222222222222222222222233333333333222222222222222222222222224555555555555555
5555555555555555442222222222222222222222222333333333333222222222222222222222222244555555555555555
5555555555555555422222222222222222222222222333333333333222222222222222222222222224455555555555555
5555555555555555422222222222222222222222222333333333333332222222222222222222222222455555555555555
5555555555555555442222222222222222222222223333333333333333322222222222222222222224455555555555555
5555555555555555442222222222222222222222333333333333333334322222222222222222222444555555555555555
5555555555555555544222222222222222222222344433333333333334222222222222222222222455555555555555555
5555555555555555554222223222222222222234445443333333334554442222222223222223424455555555555555555
5555555555555555554422444432222222242444555543333333345555542222222223443434444555555555555555555
5555555555555555555444455444244222444455555555333333555555544442222244554444555555555555555555555
5555555555555555555555555554444444455545555555553355555455555544424445555555555555555555555555555
5555555555555555555555555555555445555555555555555555555555555555444555555555555555555555555555555
5555555555555555555555555555555555555555555555555555555555555555555555555555555555555555555555555
5555555555555555555555555555555555555555555555555555555555555555555555555555555555555555555555555
5555555555555555555555555555555555555555555555555555555555555555555555555555555555555555555555555
5555555555555555555555555555555555555555555555555555555555555555555555555555555555555555555555555
5555555555555555555555555555555555555555555555555555555555555555555555555555555555555555555555555
5555555555555555555555555555555555555555555555555555555555555555555555555555555555555555555555555
5555555555555555555555555555555555555555555555555555555555555555555555555555555555555555555555555
5555555555555555555555555555555555555555555555555555555555555555555555555555555555555555555555555
5555555555555555555555555555555555555555555555555555555555555555555555555555555555555555555555555
5555555555555555555555555555555555555555555555555555555555555555555555555555555555555555555555555
5555555555555555555555555555555555555555555555555555555555555555555555555555555555555555555555555
5555555555555555555555555555555555555555555555555555555555555555555555555555555555555555555555555
OOOOOOOOOOOOOOOOOOOOOOOOOOOOOOOOOOOOOOOOOOOOOOOOOOOOOOOOOOOOOOOOOOOOOOOOOOOOOOOOOOOOOOOOOOOOOOOOO
OOOOOOOOOOOOOOOOOOOOOOOOOOOOOOOOOOOOOOOOOOOOOOOOOOOOOOOOOOOOOOOOOOOOOOOOOOOOOOOOOOOOOOOOOOOOOOOOO
OOOOOOOOOOOOOOOOOOOOOOOOOOOOOOOOOOOOOOOOOOOOOOOOOOOOOOOOOOOOOOOOOOOOOOOOOOOOOOOOOOOOOOOOOOOOOOOOO
OOOOOOOOOOOOOOOOOOOOOOOOOOOOOOOOOOOOOOOOOOOOOOOOOOOOOOOOOOOOOOOOOOOOOOOOOOOOOOOOOOOOOOOOOOOOOOOOO
OOOOOOOOOOOOOOOOOOOOOOOOOOOOOOOOOOOOOOOOOOOOOOOOOOOOOOOOOOOOOOOOOOOOOOOOOOOOOOOOOOOOOOOOOOOOOOOOO
OOOOOOOOOOOOOOOOOOOOOOOOOOOOOOOOOOOOOOOOOOOOOOOOOOOOOOOOOOOOOOOOOOOOOOOOOOOOOOOOOOOOOOOOOOOOOOOOO
OOOOOOOOOOOOOOOOOOOOOOOOOOOOOOOOOOOOOOOOOOOOOOOOOOOOOOOOOOOOOOOOOOOOOOOOOOOOOOOOOOOOOOOOOOOOOOOOO
OOOOOOOOOOOOOOOOOOOOOOOOOOOOOOOOOOOOOOOOOOOOOOOOOOOOOOOOOOOOOOOOOOOOOOOOOOOOOOOOOOOOOOOOOOOOOOOOO
OOOOOOOOOOOOOOOOOOOOOOOOOOOOOOOOOOOOOOOOOOOOOOOOOOOOOOOOOOOOOOOOOOOOOOOOOOOOOOOOOOOOOOOOOOOOOOOOO
OOOOOOOOOOOOOOOOOOOOOOOOOOOOOOOOOOOOOOOOOOOOOOOOOOOOOOOOOOOOOOOOOOOOOOOOOOOOOOOOOOOOOOOOOOOOOOOOO
OOOOOOOOOOOOOOOOOOOOOOOOOOOOOOOOOOOOOOOOOOOOOOOOOOOOOOOOOOOOOOOOOOOOOOOOOOOOOOOOOOOOOOOOOOOOOOOOO
OOOOOOOOOOOOOOOOOOOOOOOOOOOOOOOOOOOOOOOOOOOOOOOOOOOOOOOOOOOOOOOOOOOOOOOOOOOOOOOOOOOOOOOOOOOOOOOOO
OOOOOOOOOOOOOOOOOOOOOOOOOOOOOOOOOOOOOOOOOOOOOOOOOOOOOOOOOOOOOOOOOOOOOOOOOOOOOOOOOOOOOOOOOOOOOOOOO
OOOOOOOOOOOOOOOOOOOOOOOOOOOOOOOOOOOOOOOOOOOOOOOOOOOOOOOOOOOOOTOOOOOOOOOOOOOOOOOOOOOOOOOOOOOOOOOOO
OOOOOOOOOOOOOOOOOOOOOOOOOOOOOOOOOOOOOOOOOOOOOOOOOOOOOOOOOOOOOOTTTOOOOOOOOOOOOOOOOOOOOOOOOOOOOOOOO
OOOOOOOOOOOOOOOOOOOTOTTOTOOOOTOOTTOOTTOOOOOOOOOTOTOOOOOOOOOOOTOOOTOOOOOOOTOOOOOOOOOOOOOOOOOOOOOOO
OOOOOOOOOOOOOOOOOOTOTOTOOOOOOOOOOOOOTTTOOOOOTOOTTOOOTOTOOOOTTOOOOOOOOOOOOOTOOOOOOOOOOOOOOOOOOOOOO
OOOOOOOOOOOOOOOTTOOOOOOOOOOOOOOOOOOTTOOTTTTTOOOOOOOOTOTTTTTOOOOOOOOOOOOOOOOOOOOOOOOOOOOOOOOOOOOOO
OOOOOOOOOOOOOOTGGGGGGGGGGGGGGGGGGGGGGGGGGGTGGTGGGGGGGGGTGGGGGGGGGGGGGGGGGGGGGGGGGOOOOOOOOOOOOOOOO
OOOOOOOOOOOOOOTTGGGGGGGGGGGTTTTTGGGGTGGGGGTGGGGTGGGGGGGGGGGGGGGGGGTTTGGGTTGGGGGGGOOOOOOOOOOOOOOOO
OOOOOOOOOOOOOOTTGGTTGGGGTTTTTTTTTGGGGGGGGGTGGGGTGGGGGTGGGTTGGGGGGGTTTTTTTTTTTTGGGOOOOOOOOOOOOOOOO
OOOOOOOOOOOOOOTTGGGGTTGTTTTTTTTTTGTTGGGGGGGGGTTGGGGGGTTGGGGGGGGGGTTTTTTTTGGTTTGGGOOOOOOOOOOOOOOOO
OOOOOOOOOOOOOOTGGGGTTGGGGTTTTTTTTTTTTTTGGGGGGGTTGGGGGTTGGGTGGTGGGTGTTTTGGGGGGTGGGOOOOOOOOOOOOOOOO
OOOOOOOOOOOOOOOGTGGTGGGGGGGTGTTTTTTTTTGTTGGGGTTGGGGGGTTGGGGTTTTGGTTTTGGGGGGGTTGGGOOOOOOOOOOOOOOOO
OOOOOOOOOOOOOOTGGGGGTGGGGGGGGGTTTTTTTTTTTGGGTTTGGGGGGGTGGTTTTTGGGGGGGGGGGGGGGGGGGOOOOOOOOOOOOOOOO
OOOOOOOOOOOOOOOGGGGTGGGGGGGGGGGTTTGGGTTTTGGGGTTGGGGGGGGGGGTTTTGGGGGGGGGGGGGGTGGGGOOOOOOOOOOOOOOOO
OOOOOOOOOOOOOOOTGGGTTGGGGGGGGGGGGGGGGGGGTGGGTTGGGGGGGGGGGTTTTGGGGGGGGGGGGGGGTTGGGOOOOOOOOOOOOOOOO
OOOOOOOOOOOOOOOTGGTTTGGGGGGGGGGGGGGGGGGGGGGGGGGGGGGGGGGGGTTTTGGGGGGGGGGGGGGGTTTGGOOOOOOOOOOOOOOOO
OOOOOOOOOOOOOOOGGGGGTTGGGGGGGGGGGGGGGGGGGGGGGGGggggggGGGGGGGGGGGGGGGGGGGGGGTTTTGGOOOOOOOOOOOOOOOO
OOOOOOOOOOOOOOOTGGGGTTTGGGGGGGGGGGGGGGGGGGGGGGGggggggGGGGGGGGGGGGGGGGGGGGTTTTTGGGOOOOOOOOOOOOOOOO
OOOOOOOOOOOOOOOGGGGGGTTTGGGGGGGGGGGGGGGGGGGGGGGggggggGGGGGGGGGGGGGGGGGGGGTTTTTGGGOOOOOOOOOOOOOOOO
OOOOOOOOOOOOOOOGGGGGTTTGGGGGGGGGGGGGGGGGGGGGGGGGGGGGGGGGGGGGGGGGGGGGGGGGTTTTGGGGGOOOOOOOOOOOOOOOO
OOOOOOOOOOOOOOOGGGGTTTTGGGGGGGGGGGGGGGGGGGGGGGGGGGGGGGGGGTTGGGGGGGGGGGGGTTTTGGGGGOOOOOOOOOOOOOOOO
OOOOOOOOOOOOOOOGGGTTTTTTGGGGGGGGGGGGGGGGTTGTGGGGGGGGGGGGTTGTGGGGGGGGGGGGTTTGGGTGGOOOOOOOOOOOOOOOO
OOOOOOOOOOOOOOOGGGGGTTTTTGGGGGGGGGGGGGGGTGTGGGGTGGGGGTGGGTTTGGGGGGGgggggGTGGGGGTGTOOOOOOOOOOOOOOO
OOOOOOOOOOOOOOOGGGGGGTTTTGGGGGGGGGGGGGGGTTTGGGGTTGTGTTGGGTTTGGGGGGGgggggGTGGGGGGGOOOOOOOOOOOOOOOO
OOOOOOOOOOOOOOOGTGGGGGGGTTGGGGGGGTGGGGGGTTTGGGTTTGTGTGTGGTGTGGGGGGGgggggGGGGGGGGGOOOOOOOOOOOOOOOO
OOOOOOOOOOOOOOOGGTGGGGGGGGGgggggTTTTGGGGGTTTTTTTTGGGTTGTTGTTGGGGGGGGGGGGGTGGGGGGGOOOOTOOOOOOOOOOO
OOOOOOOOOOOOOOOGGTGGGGTTGGGgggggGTTTTGGGGGTTTTTGTGTGTGTTTTTGGGGGGGGGGGGGGGGGGGGGGTOOOOOOOOOOOOOOO
OOOOOOOOOOOOOOOGGGTGGGGTGGGgggggGGGTTGGGGGTGGTTGGGGGGTTTGGGGGGGGGTGGGGGGGGGGGGGGGOOOOOOOOOOOOOOOO
OOOOOOOOOOOOOOOGGGGGGGGGGGGGGGGGGGGGGGGGGGGGGGGGGGGGGGGGGGGGGGTGGGGGGGGGGGGGGGGSSOOOOOOOOOOOOOOOO
OOOOOOOOOOOOOOOGGTGGGGGGGGGGGGGGGGGGGGTGGGGGGGGGGGGGGGGGGGGGGGGGGGGGGGGGGTGGGSSWWOOOOOOOOOOOOOOOO
OOOOOOOOOOOOOOOGGGTGGGGGGGGGGGGGGGGGGGGGGGGGGGGGGGGGGGGGGGGGGGGGGGGGGGGGGSSSSSWWWOOOOOOOOOOOOOOOO
OOOOOOOOOOOOOOOGTGGGGTGTTGGGGGGGGGGGGGGGGGGGGGGGGGGGGGGGGGGGGTGGGGGGGGGGSSWWWWWWSOOOOOOOOOOOOOOOO
OOOOOOOOOOOOOOOGTTGGTTTTTGGGGGGGGGGGGGGGGGGGGGGGGGGGGGGGGGGSGGGTGGGGGGGGGWWWWSWSGOOOOOOOOOOOOOOOO
OOOOOOOOOOOOOOOGGGGGGGGGTGGGGGGGGGGGGGGGTTGGGGgggggggggGTGGSWSGGGTGGGGGGGGSSWSGGGOOOOOOOOOOOOOOOO
OOOOOOOOOOOOOOOGTGTGGGGGGGGGGGGGGGGGGGTTTTGGSSssssssssgSSWSWWWWWSSGGGGGGGGGGGGGGGOOTTTOOOOOOOOOOO
OOOOOOOOOOOOOOOGTGTGGGGGGGGGGGGGGGGGGGGGGGGSSSsssssssssSSSWWWWWWWSGGGGGTTGGGGGGGGOOTOOOOOOOOOOOOO
OOOOOOOOOOOOOOOTTGTGGGGGGGGGGGGGGGTGGGGWWGGSSSSSSSSSSSSSTSWWWWWSSSGGGGGTTGGGGGGGGTOOOOOOOOOOOOOOO
OOOOOOOOOOOOOTOTTGGGGGGGGGGGGGGGGTGGGGGGWWWSTSsssssssssSTSWGWWGGGGGGGGGTTTTGGGGGTOOOOOOOOOOOOOOOO
OOOOOOOOOOOOOOOGTGGGGTTGGGGGGGGGTTGGGGGWWWWSSSgsssssssgSSSGGGGGGGGTGGGGGGTTGTGGGGOOOOOOOOOOOOOOOO
OOOOOOOOOOOOOOOGGGGGGTTTGGGGGGGGGGGGSSWGWSSWGGgggggggggGGGTTTTGGGTGGGGGGGGGGGGGGGOOOOOOOOOOOOOOOO
OOOOOOOOOOOOOOOGGGGGGGGTTTGGGGGGSSSSWWWWWGGGGGGGGGGGGGGTTTTGTGGGGGGGGGGGGGGGGGGGGOOOOOOOOOOOOOOOO
OOOOOOOOOOOOOOOGGGGGGGGGGGGGGGGGSWWWWWWWGGGGGGGGGGGGGGGGGTTTGGGGGGGGGGGGGGGGGGTGGOOOOOOOOOOOOOOOO
OOOOOOOOOOOOOOOWWGWWTGSSSGGGGGGGSSWWWWWWGGGGGGGGGGGGGGGGTTGGGGGGGGGGGGGGGGGGGGGGGOOOOOOOOOOOOOOOO
OOOOOOOOOOOOOOOWWWWSWSSSWSGGGGGGGGGWWWWGGGGGGGGGGGGGGGGGGGGGGGGGGGGGGGGGGGTGTGGGGOOOOOOOOOOOOOOOO
OOOOOOOOOOOOOOOWWSGGGSGGSSGGGGGGGGGGGSSGGGGGGGGGGGGGGGGGGGGGGGGGTTGGGGGGTTTTGGTGGOOOOOOOOOOOOOOOO
OOOOOOOOOOOOOOOSWSGGGGGGGGGGGGGGGGGGGGGGGGGGGGGGGGGGGGGGGGGGGGGGGTGGGGGTTTGGGGGGGOOOOOOOOOOOOOOOO
OOOOOOOOOOOOOOOGGGGGGGGTTGGGGGGGGGGGTGGGGGGGGGGGGGGGGGGGGGGGGGTGGGGGGGGGTGGGGGGTGOOOOOOOOOOOOOOOO
OOOOOOOOOOOOOOOGGGGGGGGGTGGGGGGGGGGGGGGGGGGGGGGGGGGGGGGGGGGGGGGGGGGGGGGTTGGGGGGGGOOOOOOOOOOOOOOOO
OOOOOOOOOOOOOOOGGGGGGGGGGGGGGGGGGGGGGGGGGGGGTGGGGGGGGTGTGGGGGGGGTGGGGGGGGGGGGGTGGOOOOOOOOOOOOOOOO
OOOOOOOOOOOOOOOGTGGGGGGGGGGGGGGGGGGGGGGGGGGTTTTGGTGGTTTGTGGGGGGGGGGGGGGGGGGGGGGGGOOOOOOOOOOOOOOOO
OOOOOOOOOOOOOTTGGGGGGGGGGGGgggggGGTTGGGGGTTTTTTTGTGTTTGTTTGGGGGTGGGGGGGGGGGGGGGGTTOOOOOOOOOOOOOOO
OOOOOOOOOOOOOOOTTGGGGGGGGGGgggggGGTGGGGGTGTTTGTTGGGGTGGTTTGGGGTTGGGGGGGGGTGGGGGTGOTOOOOOOOOOOOOOO
OOOOOOOOOOOOOOOGTTGGGGGGGGGgggggTTGGGGGTTTTGGTTTGGGTTGGGGTGGGGGTTGGgggggGTTGGGGGGTTOOOOOOOOOOOOOO
OOOOOOOOOOOOOOOTGGGGGGGTTGGGGGGGGTGGGGGTTTGGGGTGTGGTGGGTTGTGGGGGTGGgggggGGGGGGGGTOTTOOOOOOOOOOOOO
OOOOOOOOOOOOOOOGGTGGGGGTTTGGGGGGGGGGGGGTTTGGGGGGGGGGGGGTTTGGGGGGGGGgggggGGGGGGGGGOOTOOOOOOOOOOOOO
OOOOOOOOOOOOOOOGGTGGGGTTTGGGGGGGGGGGGGGTTTTGGGGGGGGGGGGGGGGGGGGGGGGGGGGGGTTTTGGGGTTOOOOOOOOOOOOOO
OOOOOOOOOOOOOOOGGGGGGGTTGGGGGGGGGGGGGGGGGGGGGGGGGGGGGGGGGGGGGGGGGGGGGGGGGTTTTTGGGOTTOOOOOOOOOOOOO
OOOOOOOOOOOOOOOGGGGGGGGTTGGGGGGGGGGGGGGGGGGGGGGGGGGGGGGGGGGGGGGGGGGGGGGGGTTTTTGGGOTOOOOOOOOOOOOOO
OOOOOOOOOOOOOOOGTGGGGGTTTGGGGGGGGGGGGGGGGGGGGggggggggGGGGGGGGGGGGGGGGGGGGGTTTTTGGOOTOOOOOOOOOOOOO
OOOOOOOOOOOOOOOGGGGGGGGTTGGGGGGGGGGGGGGGGGGGGggggggggGGGGGGGGGGGGGGGGGGGGTTTTTTTGOOOOOOOOOOOOOOOO
OOOOOOOOOOOOOOOTGGGTTTTGGGGGGGGGGGGGGGGGGGGGGggggggggTGGGGGGGGGGGGGGGGGGGGTTTTTTGOOTOOOOOOOOOOOOO
OOOOOOOOOOOOOOOGGGGTTTTGGGGGGGGGGGGGGGGGGGGGGGGGGGGGGGGGGGGGGGGGGGGGGGGGGGGTTTTTGOOOOOOOOOOOOOOOO
OOOOOOOOOOOOOOOGGGGTTTGGGGGGGGGGGGGGGGGGGGGGGGGGGGGGGTGGGTTTGGGGGGGGGGGGGGGTTTTGGOOTOOOOOOOOOOOOO
OOOOOOOOOOOOOOOGGGGTTGGGGGGGGGGGGGGGGGGGGGGGTTGGGGGGGGGGGTTTTGGGGGGGGGGGGGGGGTTGGOOTOOOOOOOOOOOOO
OOOOOOOOOOOOOOOGGGTTTGGGGGGGGGGGGGGGGGGGGGGTTTGGGGGGGGGGGTTTTTGGGGGGGGGGGGGGTTTTGOOTOOOOOOOOOOOOO
OOOOOOOOOOOOOOOGGGGTTGGGGGGGGGGGGGGTTTGGGGGGTTGGGGGGGTTGGGGGTTTGGGGGGGGGGGGGGTTTGOOOOOOOOOOOOOOOO
OOOOOOOOOOOOOOTGGGTTTGGGGGGGGGGTTTTTTTTGGGGTTGGGGGGGGTTTGGGTTTTTGGGGGGGGGGGGTTGGGOOOOOOOOOOOOOOOO
OOOOOOOOOOOOOOTGGGGGTTGGGGTTTTGTTTTTTTTGGGGGGGGGGGGGGTTTGGGGTGTTTTTTGGGGGGGGGTGGGOTOOOOOOOOOOOOOO
OOOOOOOOOOOOOOOTGGGTTTTGGTTTTTTTTTTTTGGGGGGGGGGGGGGGGGGGGGGGTTTTTTTTGGTTTGGGGGGGTOTOOOOOOOOOOOOOO
OOOOOOOOOOOOOOTGTGGGTGGGGGGTTTGTTTGGGGGGGGGGGGGGGGGGGGGTGGGGGTTTTTTTGGGGGGGGGGGGTTOOOOOOOOOOOOOOO
OOOOOOOOOOOOOOOTTGGGGGGGGGGGGGGTTGGGGGGGTGTGGGGGGGGGGGGTTGGGGGGTTTTGGGGGGGGGGGGGTTOOOOOOOOOOOOOOO
OOOOOOOOOOOOOOOGGTGGGGGTGGGGGGGGGGGGGGGGTGGTTGGGGGGGGTGGTTGGGGGGGGGGGGTGGGGGGTTTTTOOOOOOOOOOOOOOO
OOOOOOOOOOOOOOOOOOOTOTOTTTOOOOOTOOOTOOOOTTTOOTTOOOOTTTOOOTTTTOOOOOOOOOTTTTOTTOOTTTOOOOOOOOOOOOOOO
OOOOOOOOOOOOOOOOOOOOOOOOTTTTOTOOOTTOTTTTOTTTTOOOTTTTTOOTTOTOOTTOOOOTOTTTOOTOTTTTOOOOOOOOOOOOOOOOO
OOOOOOOOOOOOOOOOOOOOOOOOOOTTTTTTTOTTOOOOOTTOTTTTTOTTTTOOOOTTOTOOTTOTTOTTOTTOOOOOOOOOOOOOOOOOOOOOO
OOOOOOOOOOOOOOOOOOOOOOOOOOOOOOOOOOOOOOOOOOOOOOOOOOOOOOOOOOOOOOOOOOOOOOOOOOOOOOOOOOOOOOOOOOOOOOOOO
OOOOOOOOOOOOOOOOOOOOOOOOOOOOOOOOOOOOOOOOOOOOOOOOOOOOOOOOOOOOOOOOOOOOOOOOOOOOOOOOOOOOOOOOOOOOOOOOO
OOOOOOOOOOOOOOOOOOOOOOOOOOOOOOOOOOOOOOOOOOOOOOOOOOOOOOOOOOOOOOOOOOOOOOOOOOOOOOOOOOOOOOOOOOOOOOOOO
OOOOOOOOOOOOOOOOOOOOOOOOOOOOOOOOOOOOOOOOOOOOOOOOOOOOOOOOOOOOOOOOOOOOOOOOOOOOOOOOOOOOOOOOOOOOOOOOO
OOOOOOOOOOOOOOOOOOOOOOOOOOOOOOOOOOOOOOOOOOOOOOOOOOOOOOOOOOOOOOOOOOOOOOOOOOOOOOOOOOOOOOOOOOOOOOOOO
OOOOOOOOOOOOOOOOOOOOOOOOOOOOOOOOOOOOOOOOOOOOOOOOOOOOOOOOOOOOOOOOOOOOOOOOOOOOOOOOOOOOOOOOOOOOOOOOO
OOOOOOOOOOOOOOOOOOOOOOOOOOOOOOOOOOOOOOOOOOOOOOOOOOOOOOOOOOOOOOOOOOOOOOOOOOOOOOOOOOOOOOOOOOOOOOOOO
OOOOOOOOOOOOOOOOOOOOOOOOOOOOOOOOOOOOOOOOOOOOOOOOOOOOOOOOOOOOOOOOOOOOOOOOOOOOOOOOOOOOOOOOOOOOOOOOO
OOOOOOOOOOOOOOOOOOOOOOOOOOOOOOOOOOOOOOOOOOOOOOOOOOOOOOOOOOOOOOOOOOOOOOOOOOOOOOOOOOOOOOOOOOOOOOOOO
OOOOOOOOOOOOOOOOOOOOOOOOOOOOOOOOOOOOOOOOOOOOOOOOOOOOOOOOOOOOOOOOOOOOOOOOOOOOOOOOOOOOOOOOOOOOOOOOO
