type octile-corner
height 97
width 97
map
2222222222222222222222222222222222222233222222232222222222222222222332333233322222222222222222222
2222222222222222222222222222222222222333332222333332222222222222222332333233322222222222222222222
2222222222222222222222222222222222222233333233333333222222222222222332333233322222222222222222222
2222222222222222222222222222222222222333333333333332222222222222223333233333332222222222222222222
2222222222222222222222222222222222222333333333333332222222222222222333333333333333333333333333333
2222222222222222222222222222222222222233333333333322222222222222223333333333333333333333333333333
2222222222222222222222222222222222222223444333333222222222222222223333333333332222222222222222222
2222222222222222222222222222222222222233444333333322222222222222223333333333333333333333333333333
2222222222222222222222222222222222222223343333333322222222222222223333333333333333333333333333333
2222222222222222222222222222222222222223333333223222222222222222222233333333333443443333333333333
2222222222222222222222222222222222222222332233333322222222222222222233333333334444444222222222222
2222222222222222222222222222222222222222222233333222222222222222222233333333344444442222222222222
2222222222222222222222222222222222222222222233332222222222222222222233333333334444444222222222222
2222222222222222222222222222222222222222222222222222222222222222222233333333334444444222222222222
2222222222222222222222222222222222222222222222222222222222222222222233333333344444444222222222222
2222222222222222222222222222222222222222222222222222222222222222222233333333344444444422222222222
2222222222222222222222222222222222222222222222222222222222222222222223333333334444444222222222222
2222222222222222222222222222222222222222222222222222222222222222222233333333334444442222222222222
2222222222222222222222222222222222222222222222222222222222222222222233333333444444444222222222222
2222222222222222222222222222222222222222222222222222222222222222222333333333444444442222222222222
0000222222222222222222222222222222222222222222222222222222222222223333333333444444444444444444444
0000022222222222222222222222222222222222222222222222222222222222223333333333344444422222222222222
0000002222222222222222222222222222222222222222222222222222222222222333333333344444222222222222222
0000000222222222222222222222222222222222222222222222222222222222222333333333322222222222222222222
0000000222222222222222222222222222222222222222222222222222222222222333333333320000000000000000000
0000000022222222222222222222222222222222222222222222222222222222222333333333320000000000000000000
0000000022222222222222222222222222222222222222222222222222222222222233333333210000000000000000000
0000000002222222222222222222222222222222222222222222222222222222222223233332200000000000000000000
0000000000022222222222222222222222222222222222222222222222222222222222213333110000000000000000000
0000000002222222222222222222222222222222222222222222222222222222222221111233310000000000000000000
0000000002222222222222222222222222222222222222222222222222222222222211111213110000000000000000000
0000000000222222222222222222222222222222222222222222222222222222222111011133310000000000000000000
0000000000242222222222222222222222222222222222222222222222222222221111100113110000000000000000000
0000000022244222222222222222222222222222222222222222222222222222221101100111100000000000000000000
0000000222244442222222222222222222222222222222222222222222222222222100101000000000000000000000000
0000000232224444442222222222222222222222222222222222222222222222222200001000000000000000000000000
0000001222324444422222222222222222222222222222222222222222222222222211100000000000000000000000000
0000000002233322222222222222222222222222222222222222222222222222222211110000000000000000000000000
0000000000223322222222222222222222222222222222222222222222222222221111110000000000000000000000000
0000000001222222222222222222222222222222222222222222222222222222221111111000000000000000000000000
0000000011122222222222222222222222222222222222222222222222222222221111111000000000000000000000000
0000001111112222222222222222222222222222222222222222222222222222221111111000000000000000000000000
0000011111112222222222222222222222222222222222222222222222222222221111111000000000000000000000000
0000011111112222222222222222222222222222222222222222222222222222221111110000000000000000000000000
0000011111112222222222222222222222222222222222222222222222222222221111111000000000000000000000000
0000011111112222222222222222222222222222222222222222222222222222222111110000000000000000000000000
0000001111112222222222222222222222222222222222222222222222222222222221000110000000000000000000000
0000011111112222222222222222222222222222222222222222222222222222222222001110000000000000000000000
0000111111112222222222222222222222222222222222222222222222222222222222111111000000000000000000000
0000011112222222222222222222222222222222222222222222222222222222222222111110000000000000000000000
0000001222222222222222222222222222222222222222222222222222222222222222211222000000000000000000000
1122222222222222222222222222222222222222222222222222222222222222222222222222200000000000000000000
3333222222222222222222222222222222222222222222222222222222222222222222222222210000000000000000000
3333322233222222222222222222222222222222222222222222222222222222222222222222110000000000000000000
3333333333333222222222222222222222222222222222222222222222222222222222222222100000000000000000000
1113333333333222222222222222222222222222222222222222222222222222222222222222110000000000000000000
1113333333333222222222222222222222222222222222222222222222222222222222222222222000000000000000000
3333333333333322222222222222222222222222222222222222222222222222222222222222222000000000000000000
3333333333333322222222222222222222222222222222222222222222222222222222222222222200000000000000000
3333333333333332222222222222222222222222222222222222222222222222222222222222222222222222222222222
3333333333333332222222222222222222222222222222222222222222222222222222222222222222222222222222222
3333333333333332222222222222222222222222222222222222222222222222222222222222222222222222222222222
1113333333333322222222222222222222222222222222222222222222222222222222222222222222222222222222222
3333333333333322222222222222222222222222222222222222222222222222222222222222222222222222222222222
3333333333333222222222222222222222222222222222222222222222222222222222222222222222222222222222222
3333333333333222222222222222222222222222222222222222222222222222222222222222222222222222222222222
1113333333333222222222222222222222222222222222222222222222222222222222222222222222222222222222222
3333333333333222222222222222222222222222222222222222222222222222222222222222222222222222222222222
1113333333333222222222222222222222222222222222222222222222222222222222222222222222222222222222222
3333333333333222222222222222222222222222222222222222222222222222222222222222222222222222222222222
3333333333333222222222222222222222222222222222222222222222222222222222222222222222222222222222222
3333333333333222222222222222222222222222222222222222222222222222222222222222222222222222222222222
3333333333333222222222222222222222222222222222222222222222222222222222222222222222222222222222222
3333333333333344442222222222222222222222222222222222222222222222222222222222222222222222222222222
3333333333334444444422222222222222222222222222222222222222222222222222222222222222222222222222222
1113333333334444456422222222222222222222222222222222222222222222222222222222222222222222222222222
3333333333444444454422222222222222222222222222222222222222222222222222222222222222222222222222222
3333333334444444444222222222222222222222222222222222222222222222222222222222222222222222222222222
3333333334444444442222222222222222222222222222222222222222222222222222222222222222222222222222222
3333333334444444442222222222222222222222222222222222222222222222222222222222222222222222222222222
3333333333344444442222222222222222222222222222222222222222222222222222222222222222222222222222222
3333333333333444442222222222222222222222222222222222222222222222222222222222222222222222222222222
3333333333333444442222222222222222222222222222222222222222222222222222222222222222222222222222222
3333333333333444442222222222222222222222222222222222222222222222222222222222222222222222222222222
3333333333333444442222222222222222222222222222222222222222222222222222222222222222222222222222222
3333333333333444442222222222222222222222222222222222222222222222222222222222222222222222222222222
3333333333333444442222222222222222222222222222222222222222222222222222222222222222222222222222222
3333333333333444442222222222222222222222222222222222222222222222222222222222222222222222222222222
3333333333333444442222222222222222222222222222222222222222222222222222222222222222222222222222222
3333333333333444442222222222222222222222222222222222222222222222222222222222222222222222222222222
3333333333333444442222222222222222222222222222222222222222222222222222222222222222222222222222222
3333333333333444442222222222222222222222222222222222222222222222222222222222222222222222222222222
3333333333333444442222222222222222222222222222222222222222222222222222222222222222222222222222222
3333333333333444442222222222222222222222222222222222222222222222222222222222222222222222222222222
3333333333333444442222222222222222222222222222222222222222222222222222222222222222222222222222222
3333333333333444442222222222222222222222222222222222222222222222222222222222222222222222222222222
3333333333333444442222222222222222222222222222222222222222222222222222222222222222222222222222222
GGGGGGGGGGGGGGGGGGGGGGGGGGGGGGGGGGGGGGGGGGGGGGGGGGGGGGGGGGGGGGGGGGGGGGGGGGGGGGGGGGGGGGGGGGGGGGGGG
OOOOOOOOOOOOOOOOOOOOOOOOOOOOOOOOOOOOOOOOOOOOOOOOOOOOOOOOOOOOOOOOOOOOOOOOOOOOOOOOOOOOOOOOOOOOOOOOG
OOOOOOOOOOOOOOOOOOOOOOOOOOOOOOOOOOOOOOOOOOOOOOOOOOOOOOOOOOOOOOOOOOOOOOOOOOOOOOOOOOOOOOOOOOOOOOOOG
OOOTTTTTOTTTTOOOOTTTTTTOOOOOOTOOTOTOOOOOOTOOTOOOTTOOOTTTTOTOOOOTTOOOOOOOOOOTOOOOOOOOOOOOOOOOOOOOG
OOOTTTTTTOTTTTOTOTOTTTOOOOOOTTTTTTOTOOTOOOTTTOOOTOOTTTTTTTTTOTTTTOOOTOOTTOTTTOOOOOOOOOOOOOOOOOOOG
OOOTTTTTTTOTTOTTTOTTTTOTOTTTTTTTTTTOOOOTTOOOOTTTOOOOTTTOTOTOTTTTTOOOOTTOOTTTTTOOOOOOOOOOOOOOOOOOG
OOOTTTGTTTTTTTTTTTTTTGTTTGTTTGTGGGGGTGGGGGGTGGGGGGGTTTGTGTGTTTTTTGTTTTGTTTTTOOOOOOOOOOOOOOOOOOOOG
OOTTTTTTTTTTTTTGTTTTGTTTGTTTTTTTGTTGTGGGTTGGTTTGGGTTGGTGTTTTTTTTTGTTTGTTTTTTTOOOOOOOOOOOOOOOOOOOG
OOTTTGTTTTTTGTGTTTTTTGGTTTTTTTGTTTTTTGGGGGGGTTTTGGGTTGGGTTTTTTTTTGGTTGGGGTTTTTOOOOOOOOOOOOOOOOOOG
OOTTGTTTTTTTTTTTTTTTGTTGTTTTTTGGTTTTTTGTGGGTTGGGGGGGTTGTGTGTTTTTGGGGGGGGGTTTTOOOOOOOOOOOOOOOOOOOG
OOTOTGGTTTTTTTGTTTTTTTTGTTTTTTTTTTTTTGGGTGGGTGGGGGGTTGTGTGTTGTTTTTgggGGGGGTTOOOOOOOOOOOOOOOOOOOOG
OOOTGTTGTTTTTTTGTTTGTTGTTTTTGTTTTTGTTGTGGGTGTTGTGGTGGTTTGTTTGGGGGTttgGGGGGTTOOOOOOOOOOOOOOOOOOOOG
OOTOTTTTGTTTTGTTTGGGGTTTTTTTTTTTGTTTTTTTTTTGGGTGGTGTTTTGGGTGGGGGGGgggGGGGGTGOOOOOOOOOOOOOOOOOOOOG
OOOTTTTTTTGGGGGGGGGGGGGTTGTGTTTTTTTTGTTTGTTGGGGGTTGTTGTTTGGGGGGGGGgggGGGGGTTOOOOOOOOOOOOOOOOOOOOG
OOOOTTTTTTTTGGGGGGGGGGGGTTTTTTTTTTTGTTTTTTTTTTTTTTTTTGGTGGGGGGGGGGgggGGGGGTTOOOOOOOOOOOOOOOOOOOOG
OOOOTTTTTTTTGGGGGGGGGGGGTTTTTTTGTGGGGGGTTTTTTTTTTGTTTTTGTGGGGGGGGGgggGGGGGTTOTOOOOOOOOOOOOOOOOOOG
OOOTGTTTTTTTGGGGGGGGGGGGTTTTTTGGGGGGGGGTTTGTTTTTGGGGGGTTGGGGGGGGGGGGGGGGGGTTOOOOOOOOOOOOOOOOOOOOG
OOOOTGGTTTTTGGGGGGGGGGGGGTTTTTGGGGGGGGGGTGTTGGTTTGGGGGGGGGGGGGGGGTTGGGGGGGTTTOOOOOOOOOOOOOOOOOOOG
OOOTTTTTTTTTGGGGGGGGGGGGTTTTGGGGGGGGGGGGGTTTTTGTGGGGGGGGGGGGGGGGGTTGGGGGGGTGOOOOOOOOOOOOOOOOOOOOG
OOOOTTTTTTGTGGGGGGGGGGGGTTTTTGGGGGGGGGGGGGGTTGTTTGGGGGGGGGGGGGGGTGGGGGGGGGGGOOOOOOOOOOOOOOOOOOOOG
OOOOGGTTTGTTTGGGGGGGGGGTGTTTGGGGGGGGGGGGGGGGTTTTTGGGGGGGGGGGGGGGTGGGGGGGGGGGOOOOOOOOOOOOOOOOOOOOG
OOOOWTTGTTTTTGGGGGGGGGGTTTTGGGGGGGGGGGGGGGGGTTTGTGGGGGGGGGGGGGGGGGGGGGGGGGGGOOOOOOOOOOOOOOOOOOOOG
OOOOWWGTTTTTTGGGGGGGGGGGTTTGGGGGGGGGGGGGGGGGGTTTTTGGGGGGGGGGGGGGGGGGGGGGGGGGOOOOOOOOOOOOOOOOOOOOG
OOOOWWWTTGTTGGTGGGGGGGGGGGGGGGGGGGGGGGGGGGGGGTGTTTTGGGGGGGGGGGGGGGGTGGGGGGGGOOOOOOOOOOOOOOOOOOOOG
OOOOWWWTGTTTTTGTGGGGGGGGGGGGGGGGGGGGGGGGGGGGGTTTGTTTTGGGGGGGGGGGGGGTTGGGGGGGOOOOOOOOOOOOOOOOOOOOW
OOOOWWWWGTTGTGTTGGGGGGGGGGGGGGGGGGGGGGGGGGGGGGTTTTTTTGGGGGGGGGGGGGGGTTGGGGGGOOOOOOOOOOOOOOOOOOOOW
OOOOWWWWGGGGTTGGTGGGGGGGGGGGGGGGGGGGGGGGGGGGGGGTTGGTTGGGGGGGGGGGGGGGTTTTTTTGOOOOOOOOOOOOOOOOOOOOW
OOOOWWWWWGTTGTGGGGGGGGGGGGGGGGGGGGGGGGGGGGGGGGGTTGGTGGGGGGGGGGGGGGTGGGGGTTGGOOOOOOOOOOOOOOOOOOOOW
OOOOWWWWWWWGTGGGGGGGGGGGGGGGGGGGGGGGGGGGGGGGGGGGGGGGGGGGGGGGGGGGGGTTGGGSTTGGOOOOOOOOOOOOOOOOOOOOW
OOOOWWWWWGGGTTGGGGGGGGGGGGTTTTTTTTGGGGGGGGGGGGGGGGGGGGGGGGGGGGGGGGTTGSSSSGTGOOOOOOOOOOOOOOOOOOOOW
OOOOWWWWWGGTTTGGGTGGGGGGGGTGTTTTTTTTGGGGGGGGGGGGGGGGGGGGGGGGTGGGGTTGSSSSSGSGOOOOOOOOOOOOOOOOOOOOW
OOOOWWWWWSTTGTTTTGGGGGGGTTTTTTTTTTGTTGGGGGGGGGGGGGGGGGGGGGGTTGGGGTGSSSWSSSGGOOOOOOOOOOOOOOOOOOOOW
OOOOWWWWWSGGGGTTTGGGGGGGGTTTTGGTTTGGTTGGGGGGGGGGGGGGGGGGGGGTTGGGGGSSSSSWWSSGOOOOOOOOOOOOOOOOOOOOW
OOOOWWWWGGGGGTTGTTGGGGGGGGGTGTTTGTTGTTTGGGGGGGGGGGGGGGGGGGTTGGGGGGSSWSSWWSSSOOOOOOOOOOOOOOOOOOOOW
OOOOWWWGGGGGGGGTTGGGGGGGGGGGGGGGTGTTTGTTTGGGGGGGGGGGGGGGGGTTTGGGGGGSWWSWSWWWOOOOOOOOOOOOOOOOOOOOW
OOOOWWWGGGGGTTGGGGGGGGGGGGGGGGGGGGGGGTTTGTGGGGGGGGGGGGGGGGTTTGGGGGGGWWWWSWWWOOOOOOOOOOOOOOOOOOOOW
OOOOWWSGGGGGGTTTGGGGGGGGGGGGGGGGGGGGGGTGTTTTGGGGGGGGGGGGGGGTTGGGGGGGSSSWWWWWOOOOOOOOOOOOOOOOOOOOW
OOOOWWWWWGGGGGGGGTTTGGGGGGGGGGGGGGGGGGTTTGGTGGGGGGTTTGGGGGGTGGGGGGGGTTTSWWWWOOOOOOOOOOOOOOOOOOOOW
OOOOWWWWWWGGTGTTTTGTTGGGGGGGGGGGGGGGGGGGTGTTTGTTGGTTTGGGGGGGGGGGGGSSSSSSWWWWOOOOOOOOOOOOOOOOOOOOW
OOOOWWWWWSGGGGGTTTTTGGGGGGGGGGGGGGGGGGGGGGTGTTGGTGTTGGGGGGGGGGGGGgssSSSSSWWWOOOOOOOOOOOOOOOOOOOOW
OOOOWWWWSSSGGTTTTTTTGGGGGGGGGGGGGGGGGGGGGGGTTTTGTTTTTGGGGGGGGGGGGggsSSSSSWWWOOOOOOOOOOOOOOOOOOOOW
OOOOWWSSSSSTGTGTTGGGGGGGGGGTGGGGGGGGGGGGGGGGGTGTTGTTGGGGGGGGGGGGGgssSGGSSWWWOOOOOOOOOOOOOOOOOOOOW
OOOOWSSSSSssgGTGTGGGGGGGGGGGTTGGGGGGGGGGGGGGGGTGTTGGGGGGGGGGGGGGGgssSSGSSWWWOOOOOOOOOOOOOOOOOOOOW
OOOOWTSSSSssgGGGGTGGGGGGGGGTTTGGGGGGGGGGGGGGGGGGGGGGGGGGGGGGGGGGGgssSSSSWWWWOOOOOOOOOOOOOOOOOOOOW
OOOOWSSSSSsggGGGGGGGGGGGGGGTTTGGGGGGGGGGGGGGGGGGGGGGGGGTTTGGGGGGGGSSSSSSSWWWOOOOOOOOOOOOOOOOOOOOW
OOOOWSSSSSsggGGGGGGGGGGGGGTGGGGGGGGGTTGGGGGGGGGGGGGGGGGTTTTGGGGGGGGSSSSSWWWWOOOOOOOOOOOOOOOOOOOOW
OOOOWWSSSSsggGGGGGGGGGGGGGGGGGGGGGGTTTTGGGGGGGGGGGGGGGGTGTTGGGGGGGGGGSWWWSSWOOOOOOOOOOOOOOOOOOOOW
OOOOWSSSSSssgGGGGGGGGGGGGGGGGGGGGGGTTTTGGGGGGGGGGGGGGGGTTTGGGGGGGGGGGGWWSSSWOOOOOOOOOOOOOOOOOOOOW
OOOOSSSSSSSTGGGGGGGGGGGGGGGGGGGGGGGGTTTGGGGGGGGGGGGGGGTGGGGGGGGGGGGGGGSSSSSSOOOOOOOOOOOOOOOOOOOOW
OOOOWSTSSGGGGGGGGGGGGGGGGGGGGGGGGGGGTTTGGGGGGGGGGGGGGGTTGGGGGGGGGGGGGGSSSSSWOOOOOOOOOOOOOOOOOOOOW
OOOOWWSGGTTTTGGGGGGGGGGGGGGGGGGGGGGGTTTGGGGGGGGGGGGGGGTTTGGGGGGGGGGGGGGSSGGGOOOOOOOOOOOOOOOOOOOOW
OOOOGGGGGGTTTTGGGGGGGGGGGGGGGGTTGGGTGTTTGGGGGGGGGGGGGGTGTGGGGGGGGGGGTTGGGGTGOOOOOOOOOOOOOOOOOOOOW
OOOOGGGGGGTGTGTGGGGGGGGGGGGGGTTTTGGTTTTTTTGGGGGGGGGGGGTTTTTGGGGGGGGTTTTGTTTGOOOOOOOOOOOOOOOOOOOOW
OOOOGTTGGGGTGGTTTTGTGGGGGGGGGTTTTTTTTTGTTTTGGGGGGGGGGGTTTTTGGGGGGGGTTTTTGTTGOOOOOOOOOOOOOOOOOOOOW
OOOOGGGGTGGGGTGTTTTGTTGGGGGGGGGTTGTGTGTTTTTTGGGGGGGGGGGTTTTGGGGGGGTTTTTGTTGGOOOOOOOOOOOOOOOOOOOOW
OOOTTTTTTTTTGTTTTTGTTTGGGGGGGGGGGTTTGTTTTTTTTGGGGGGGGGTTTTGGGGGGGGTTTTTTTGTGOOOOOOOOOOOOOOOOOOOOW
OOOOTTTGGGGTGGTTTTTGGGGGGGGGGGGGGGTTTTTTTTGTTTGGGGGGGGGTGGGGGGGGGGGGGGGTTTTGOOOOOOOOOOOOOOOOOOOOW
OOOTTTTGGGGGGGTTGGGGGGGGGGGGGGGGGGGGTTGGGGTGTTTGGGGGGGGGGGGGGGGGGGGGGGGGTTGTTOOOOOOOOOOOOOOOOOOOW
OOTOTTGGGGGGGGTGGGGGGGGGGGGGGGGGGGGGGGGGGGGTGTTTGGGGGGGGGGGGGGGGGGGGGGGGTTGTTOOOOOOOOOOOOOOOOOOOW
OOOTTGTGGGGGGGGGGGGGGGGGGTGGGGGGGGGGGGGGGGGGTTTTTGGGGGGGGGGGGGGGGGGGGGGTTGTGTTOOOOOOOOOOOOOOOOOOG
OOTTTTGGGGGGGGGGGGGGGGGTTTTGGGGGGGGGGGGGGGGGTTTTTTGGGGGGGGGGGGGGGGGGGGGTTTTTTOOOOOOOOOOOOOOOOOOOG
OOTOTTGGGGGGGGGGGGGGGGTTTTGTGGGTGGGGGGGGGGGGGGTTTTTTGGGGGGGGGGGGGGGGGTTTGTTTTOOOOOOOOOOOOOOOOOOOG
OOOOTTGGGGGGGGGGGGGGGGTTGGTGGGTGTGGGGGGGGGGGGGGTGTTTTGGGGGGGGGGGGGGGTTGTTTTTTTOOOOOOOOOOOOOOOOOOG
OOOTGTGGGGGGGGGGGGGGGGTTTTTTTTGTTTGGGGGGGGGGGGGTTGGTGTGGGGGGGGGGGGGGGTTTTTGTTOOOOOOOOOOOOOOOOOOOG
OOOTTGGGGGGGGGGGGGGGGGTTTTTTTGTTTGGGGGGGGGGGGGGGTTTGTTGGGGGGGGGGGGGGGGTTTTTTOOOOOOOOOOOOOOOOOOOOG
OOOOTTTGGGGGGGGGGGGGGGTTTGTTTTTTGGGGGGGGGGGGGGGGGGTTTGGGGGGGGGGGGGGGGGTGTTTTTOOOOOOOOOOOOOOOOOOOG
OOOTTTGGGGGGgggGGGGGGGGTTTGTTTTTGGGGGGGGGGGGGGGGGGGGGGGGGGGGGGGGGGGGGGGTGTTGTTOOOOOOOOOOOOOOOOOOG
OOOOTTTGGGGGgggGGGGGGGGTTGTTTTGTGGGGGGGGGGGGGGGGGGGGGGGGGGGGGGGGGGGGGGTTTTGTTTOOOOOOOOOOOOOOOOOOG
OOOOTTTGGGGGgggGGGGGGGGTTTTTTTTTGGGGGGGGGGGGGGGGGGGGGGGGGGGTTGGGGGGGGGTTTGGGOTOOOOOOOOOOOOOOOOOOG
OOOTGTTGGGGGgggGGGGGGGGGTTTTTTGTTGGGGGGGGGGGGGGGGGGGGGGGGGGTTTGGGGGGGGGTTTGTOOOOOOOOOOOOOOOOOOOOG
OOOTTTTGGGGGgggGGGGGGGGGTGTTGTGTTTTTGGGGGGGGGGGGGGGGGGGGGGGTTTGGGGGGGGTTTTTTTOOOOOOOOOOOOOOOOOOOG
OOOTTGTTGGGGgggGGTTTGGGGTTGGTTTGTTTGTTTGGGGGGGGGTTGTGGGGGGGTTTGGGGGGGGGTTTTTTTOOOOOOOOOOOOOOOOOOG
OOOOTTTTTGGGGGGGGTTTTTTTGTTTTGTTTTTTTTTTTTTGGGGGTGTTTGGGGGTTTTTTTTGTTGGTTTTTOTOOOOOOOOOOOOOOOOOOG
OOOOTTTGTTTTGGGGGGTTGTTTGTTTTTTTTGTTTTTTTTTGGGGTGTTTGTGGGTTTGGTTGTTTTTTTGTTGTOOOOOOOOOOOOOOOOOOOG
OOOTTTTTTTTGGGGGGGGGGTTTTGTTTTTTTTTGTTTTTTTTTTTTTTTTTTGTTTTTGTTTTTTTTGTTTTTTTTOOOOOOOOOOOOOOOOOOG
OOOOTTTTTTTGGGGGGGGGGTGGGTTTGTTTTTTTTTTTGTTTTTTTGTTTTTTTTTTGTTTGTTTTTTTTTTTTTOOOOOOOOOOOOOOOOOOOG
OOOOGTGTGGGGGGGGGGGGGGTTTTGGTGTTTTTGTTTTTTTTTGTTTTTTTGTTTTTTGTTTTTTTTGTTGTTTTTOOOOOOOOOOOOOOOOOOG
OOOOGGGGGGGGGGGGGGGGGTTTTTTTGTGGTGGGGTGGGTTTTTTTTGGTTTTGTGTGGGTTGTGTGTGGTGTGOTOOOOOOOOOOOOOOOOOOG
OOOOOOOOOOOOOOOOOOOOTOTTOOOOTOOOOOOOOOOOOOTOTTOTTOOOOOOOOOOOOOTTOOOOOOOTOOOOOTOOOOOOOOOOOOOOOOOOG
OOOOOOOOOOOOOOOOOOOOOOOOOOOOOOOOOOOOOOOOOOOOOOOOOOOOOOOOOOOOOOOOOOOOOOOOOOOOOOOOOOOOOOOOOOOOOOOOG
OOOOOOOOOOOOOOOOOOOOOOOOOOOOOOOOOOOOOOOOOOOOOOOOOOOOOOOOOOOOOOOOOOOOOOOOOOOOOOOOOOOOOOOOOOOOOOOOG
OOOOOOOOOOOOOOOOOOOOOOOOOOOOOOOOOOOOOOOOOOOOOOOOOOOOOOOOOOOOOOOOOOOOOOOOOOOOOOOOOOOOOOOOOOOOOOOOG
OOOOOOOOOOOOOOOOOOOOOOOOOOOOOOOOOOOOOOOOOOOOOOOOOOOOOOOOOOOOOOOOOOOOOOOOOOOOOOOOOOOOOOOOOOOOOOOOG
OOOOOOOOOOOOOOOOOOOOOOOOOOOOOOOOOOOOOOOOOOOOOOOOOOOOOOOOOOOOOOOOOOOOOOOOOOOOOOOOOOOOOOOOOOOOOOOOG
OOOOOOOOOOOOOOOOOOOOOOOOOOOOOOOOOOOOOOOOOOOOOOOOOOOOOOOOOOOOOOOOOOOOOOOOOOOOOOOOOOOOOOOOOOOOOOOOG
OOOOOOOOOOOOOOOOOOOOOOOOOOOOOOOOOOOOOOOOOOOOOOOOOOOOOOOOOOOOOOOOOOOOOOOOOOOOOOOOOOOOOOOOOOOOOOOOG
OOOOOOOOOOOOOOOOOOOOOOOOOOOOOOOOOOOOOOOOOOOOOOOOOOOOOOOOOOOOOOOOOOOOOOOOOOOOOOOOOOOOOOOOOOOOOOOOG
OOOOOOOOOOOOOOOOOOOOOOOOOOOOOOOOOOOOOOOOOOOOOOOOOOOOOOOOOOOOOOOOOOOOOOOOOOOOOOOOOOOOOOOOOOOOOOOOG
OOOOOOOOOOOOOOOOOOOOOOOOOOOOOOOOOOOOOOOOOOOOOOOOOOOOOOOOOOOOOOOOOOOOOOOOOOOOOOOOOOOOOOOOOOOOOOOOG
OOOOOOOOOOOOOOOOOOOOOOOOOOOOOOOOOOOOOOOOOOOOOOOOOOOOOOOOOOOOOOOOOOOOOOOOOOOOOOOOOOOOOOOOOOOOOOOOG
OOOOOOOOOOOOOOOOOOOOOOOOOOOOOOOOOOOOOOOOOOOOOOOOOOOOOOOOOOOOOOOOOOOOOOOOOOOOOOOOOOOOOOOOOOOOOOOOG
OOOOOOOOOOOOOOOOOOOOOOOOOOOOOOOOOOOOOOOOOOOOOOOOOOOOOOOOOOOOOOOOOOOOOOOOOOOOOOOOOOOOOOOOOOOOOOOOG
OOOOOOOOOOOOOOOOOOOOOOOOOOOOOOOOOOOOOOOOOOOOOOOOOOOOOOOOOOOOOOOOOOOOOOOOOOOOOOOOOOOOOOOOOOOOOOOOG
OOOOOOOOOOOOOOOOOOOOOOOOOOOOOOOOOOOOOOOOOOOOOOOOOOOOOOOOOOOOOOOOOOOOOOOOOOOOOOOOOOOOOOOOOOOOOOOOG
OOOOOOOOOOOOOOOOOOOOOOOOOOOOOOOOOOOOOOOOOOOOOOOOOOOOOOOOOOOOOOOOOOOOOOOOOOOOOOOOOOOOOOOOOOOOOOOOG
OOOOOOOOOOOOOOOOOOOOOOOOOOOOOOOOOOOOOOOOOOOOOOOOOOOOOOOOOOOOOOOOOOOOOOOOOOOOOOOOOOOOOOOOOOOOOOOOG
OOOOOOOOOOOOOOOOOOOOOOOOOOOOOOOOOOOOOOOOOOOOOOOOOOOOOOOOOOOOOOOOOOOOOOOOOOOOOOOOOOOOOOOOOOOOOOOOG
