type octile-corner
height 129
width 97
map
1111111111111111111111111111111111111111111111111222444444444444444444444444444444444444444444444
1111111111111111111111111111111111111111111111111224444444444444444444444444444444444444444444444
1111111111111111111111111111111111111111111111111222444444444444444444444444444444444444444444444
1111111111111111111111111111111111111111111111111222444444444444444444444444444444444444444444444
1111111111111111111111111111111111111111111111112224444444444444444444444444444444444444444444444
1111111111111111111111111111111111111111111111122222444444444444444444444444444444444444444444444
1111111111111111111111112211111111111111111111122224444444444444444444444444444444444444444444444
1111111111111111111111122222111111112111122211222244444444424244444444444444444444444444444444442
1111111111111111111111122222221221222222222222222444444424222224444444444444444444444444444444444
1111111111111111111111222222222222222222222222222244424222222222422242444444444444444444444444442
1111111111111111112122222222222222222222222222222224222222222222222222422444444444444444444422422
1111111111111111112222222222222222222222222222222222222222222222222222222244244444244444442222222
1111111111111111122222222222222222222222222222222222222222222222222222222222244422222444422222222
1111111111111111122222222222222222222222222222222222222222222222222222222222224222224444442221111
1111111111111111122222222222222222222222222222222222222222222222222222222222222222222424422211111
1111111111111111112222222222222222222222222222222222222222222222222222222222222222222222222211111
1111111111111111122222222222222222222222222222222222222222222222222222222222222222222222222211111
1111111111111111122222222222222222222222222222222222222222222222222222222222222222222222221111111
1111111111111111222222222222222222222222222222222222222222222222222222222222222222222222221111111
1111111111112122222222222222222222222222222222222222222222222222222222222222222222222222211111111
1111111111122222222222222222222222222222222222222222222222222222222222222222222222222222211111111
1111111111222222222222222222222222222222222222222222222222222222222222222222222222222222111111111
1111111122222222222222222222222222222222222222222222222222222222222222222222222222222222111111111
1111112222222222222222222222222222222222222222222222222222222222222222222222222222222222211111111
1111112222222222222222222222222222222222222222222222222222222222222222222222222222222222221111111
1111122222222222222222222222222222222222222222222222222222222222222222222222222222222222221111111
1111122222222222222222222222222222222222222222222222222222222222222222222222222222222222221111111
1111112222222222222222222222222222222222222222222222222222222222222222222222222222222222211111111
1111122222222222222222222222222222222222222222222222222222222222222222222222222222222222111111111
1111122222222222222222222222222222222222222222222222222222222222222222222222222222222222111111111
1111112222222222222222222222222222222222222222222222222222222222222222222222222222222222111111111
1111111222222222222222222222222222222222222222222222222222222222222222222222222222222222211111111
1111111222222222222222222222222222222222222222222222222222222222222222222222222222222222211111111
1111111122222222222222222222222222222222222222222222222222222222222222222222222222222222221111111
1111111222222222222222222222222222222222222222222222222222222222222222222222222222222222222111111
1111111222222222222222222222222222222222222222222222222222222222222222222222222222222222222211111
1111112222222222222222222222222222222222222222222222222222222222222222222222222222222222222211111
1111122222222222222222222222222222222222222222222222222222222222222222222222222222222222222211111
1111112222222222222222222222222222112222222222222222222222222222222222222222222222222222222211111
1111111222222222222222222222222222112222222222222222222222222222222222222222222222222222222211111
1111111122222222222222222222222222111222222222222222222222222222222222222222222222222222222211111
1111111122222222222222222222222222212222222222222222222222222222222222222222222222222222222221111
1111111112222222222222222222222222222222222222222222222222222222222222222222222222222222222211111
1111111122222222222222222222222222222222222222222222222222222222222222222222222222222222222211111
1111111122222222222222222222222222222222222222222222222222222222222222222222222222222222222221111
1111111222222222222222222222222222222222222222222222222222222222222222222222222222222222222221111
1111112222222222222222222222222222222222222222222222222222222222222222222222222222222222222211111
1111112222222222222222222222222222222222222222222222222222222222222222222222222222222222222221111
1111112222222222222222222222222222222222222222222222222222222222222222222222222222222222222221111
1111122222222222222222222222222222222222222222222222222222222222222222222222222222222222222221111
1111122222222222222222222222222222222222222222222222222222222222222222222222222222222222222211111
1111222222222222222222222222222222222222222222222222222222222222222222222222222222222222222211111
1111222222222222222222222222222222222222222222222222222222222222222222222222222222222222222221111
1112222222222222222222222222222222222222222222222222222222222222222222222222222222222222222211111
1222222222222222222222222222222222222222222222222222222222222222222222222222222222222222222111111
2222222222222222222222222222222222222222222222222222222222222222222222222222222222222222222111111
2222222222222222222222222222222222222222222222222222222222222222222222222222222222222222211111111
2222222222222222222222222222222222222222222222222222222222222222222222222222222222222222111111111
2222222222222222222222222222222222222222222222222222222222222222222222222222222222222222211111111
2222222222222222222222222222222222222222222222222222222222222222222222222222222222222222211111111
2222222222222222222222222222222222222222222222222222222222222222222222222222222222222222211111111
2222222222222222222222222222222222222222222222222222222222222222222222222222222222222222211111111
2222222222222222222222222222222222222222222222222222222222222222222222222222222222222222221111111
2222222222222222222222222222222222222222222222222222222222222222222222222222222222222222222111111
2222222222222222222222222222222222222222222222222222222222222222222222222222222222222222222211111
2222222222222222222222222222222222222222222222222222222222222222222222222222222222222222222111111
2222222222222222222222222222222222222222222222222222222222222222222222222222222222222222221111111
2222222222222222222222222222222222222222222222222222222222222222222222222222222222222222221111111
2242222222222222222222222222222222222222222222222222222222222222222222222222222222222222221111111
4444422222222222222222222222222222222222222222222222222222222222222222222222222222222222222111111
4444442222222222222222222222222222222222222222222222222222222222222222222222222222222222222211111
4444444222222222222222222222222222222222222222222222222222222222222222222222222222222222222111111
4444444442222222222222222222222222222222222222222222222222222222222222222222222222222222221111111
4444444444222222222222222222222222222222222222222222222222222222222222222222222222222222211111111
4444444444222222222222222222222222222222222222222222222222222222222222222222222222222222221111111
4444444444422222222222222222222222222222222222222222222222222222222222222222222222222222221111111
4444444444222222222222222222222222222222222222222222222222222222222222222222222222222222221111111
4444444444222222222222222222222222222222222222222222222222222222222222222222222222222222221111111
4444444442222222222222222222222222222222222222222222222222222222222222222222222222222222222111111
4444444222222222222222222222222222222222222222222222222222222222222222222222222222222222222211111
4444442222222222222222222222222222222222222222222222222222222222222222222222222222222222222111111
4444442222222222222222222222222222222222222222222222222222222222222222222222222222222222222111111
4444422222222222222222222222222222222222222222222222222222222222222222222222222222222222222111111
4444422222222222222222222222222222222222222222222222222222222222222222222222222222222222222211111
4444422222222222222222222222222222222222222222222222222222222222222222222222222222222222222211111
4444442222222222222222222222222222222222222222222222222222222222222222222222222222222222222111111
4444442222222222222222222222222222222222222222222222222222222222222222222222222222222222222111111
4444444222222222222222222222222222222222222222222222222222222222222222222222222222222222222111111
4444442222222222222222222222222222222222222222222222222222222222222222222222222222222222221111111
4444442222222222222222222222222222222222222222222222222222222222222222222222222222222222222111111
4444444222222222222222222222222222222222222222222222222222222222222222222222222222222222222111111
4444444422222222222222222222222222222222222222222222222222222222222222222222222222222222221111111
4444444222222222222222222222222222222222222222222222222222222222222222222222222222222222222111111
4444442222222222222222222222222222222222222222222222222222222222222222222222222222222222222111111
4444444222222222222222222222222222222222222222222222222222222222222222222222222222222222222111111
4444442222222222222222222222222222222222222222222222222222222222222222222222222222222222222211111
4444442222222222222222222222222222222222222222222222222222222222222222222222222222222222222211111
4444422222222222222222222222222222222222222222222222222222222222222222222222222222222222222111111
4444222222222222222222222222222222222222222222222222222222222222222222222222222222222222222111111
4444442222222222222222222222222222222222222222222222222222222222222222222222222222222222221111111
4444444222222222222222222222222222222222222222222222222222222222222222222222222222222222222111111
4444444222222222222222222222222222222222222222222222222222222222222222222222222222222222222111111
4444444422222222222222222222222222222222222222222222222222222222222222222222222222222222222111111
4444444222222222222222222222222222222222222222222222222222222222222222222222222222222222222111111
4444444222222222222222222222222222222222222222222222222222222222222222222222222222222222222111111
4444442222222222222222222222222222222222222222222222222222222222222222222222222222222222221111111
4444442222222222222222222222222222222222222222222222222222222222222222222222222222222222222111111
4444444222222222222222222222222222222222222222222222222222222222222222222222222222222222221111111
4444444222222222222222222222222222222222222222222222222222222222222222222222222222222222221111111
4444444422222222222222222222222222222222222222222222222222222222222222222222222222222222222111111
4444444222222222222222222222222222222222222222222222222222222222222222222222222222222222221111111
4444444222222222222222222222222222222222222222222222222222222222222222222222222222222222221111111
4444442222222222222222222222222222222222222222222222222222222222222222222222222222222222211111111
4444442222222222222222222222222222222222222222222222222222222222222222222222222222222222211111111
4444444422222222222222222222222222222222222222222222222222222222222222222222222222222222221111111
4444444442222222222222222222222222222222222222222222222222222222222222222222222222222221111111111
4444444422222222222222222222222222222222222222222222222222222222222222222222222222222211111111111
4444444444222222222222222222222222222222222222222222222222222222222222222222222222222111111111111
4444444444422222222222222222222222222222222222222222222222222222222222222222222222222111111111111
4444444444422222222222222222222222222222222222222222222222222222222222222222222221221111111111111
4444444444442222222222222222222222222222222222222222222222222222222222222222222211111111111111111
4444444444422222222222224222222222222222222222222222222222222222222222222222222211111111111111111
4444444444422222222222244422222422222222222222222222222222222222222222222222221111111111111111111
4444444444422222422222244222222442222222222222222222222222222222222212222212211111111111111111111
4444444444444244444242444442224444422222222222224242244244422222221111112111111111111111111111111
4444444444444444444444444444444444442422422242244444444444444422211111111111111111111111111111111
4444444444444444444444444444444444444444442444444444444444444422221111111111111111111111111111111
4444444444444444444444444444444444444444444444444444444444444222221111111111111111111111111111111
4444444444444444444444444444444444444444444444444444444444442222211111111111111111111111111111111
WWWWWWWWWWWWWWWWWWWWWWWWWWWWWWWWWWWWWWWWWWWWWWWWWSSSGGGGGGGGGGGGGGGGGGGGGGGGGGGGGGGGGGGGGGGGGGGGG
OOOOOOOOOOOOOOOOOOOOOOOOOOOOOOOOOOOOOOOOOOOOOOOOOOOOOOOOOOOOOOOOOOOOOOOOOOOOOOOOOOOOOOOOOOOOOOOOG
OOOOOOOOOOOOOOOOOOOOOOOOOOOOOOOOOOOOOOOOOOOOOOOOOOOOOOOOOOOOOOOOOOOOOOOOOOOOOOOOOOOOOOOOOOOOOOOOG
OOOOOOOOOOOOOOOOOOOOOOOOOOOOOOOOOOOOOOOOOOOOOOOOOOOOOOOOOOOOOOOOOOOOOOOOOOOOOOOOOOOOOOOOOOOOOOOOG
OOOOOOOOOOOOOOOOOOOOOOOOOOOOOOOOOOOOOOOOOOOOOOOOOOOOOOOOOOOOOOOOOOOOOOOOOOOOOOOOOOOOOOOOOOOOOOOOG
OOOOOOOOOOOOOOOOOOOOOOOOOOOOOOOOOOOOOOOOOOOOOOOOOOOOOOOOOOOOOOOOOOOOOOOOOOOOOOOOOOOOOOOOOOOOOOOOG
OOOOOOOOOOOOOOOOOOOOOOOOOOOOOOOOOOOOOOOOOOOOOOOOOOOOOOOOOOOOOOOOOOOOOOOOOOOOOOOOOOOOOOOOOOOOOOOOG
OOOOOOOOOOOOOOOOOOOOOOOOOOOOOOOOOOOOOOOOOOOOOOOOOOOOOOOOOOOOOOOOOOOOOOOOOOOOOOOOOOOOOOOOOOOOOOOOS
OOOOOOOOOOOOOOOOOOOOOOOOOOOOOOOOOOOOOOOOOOOOOOOOOOOOOOOOOOOOOOOOOOOOOOOOOOOOOOOOOOOOOOOOOOOOOOOOG
OOOOOOWWWWWWWWWWWWWWWWSSSSGSSSSSSSSSGGGGTGGGTTGGGGGGGGGGGGGGGGGGGGGGGGGGGGGGGGGGGGGGGGGGGGOOOOOOS
OOOOOOWWWWWWWWWWWWSWSSSSTGGGGGGGGGGGTGGGGGGGTTTTGGGGGGGGGGTGGGGGGGGGGGGGGGGGGGGGGGGGGGGGGGOOOOOOS
OOOOOOWWWWWWWWWWWWSSSSTTTTGGTGGTGGTTTTTGGGGTTTTTGGGGTGGGTTTTGTTTTGGTGGGGGGGGGGGGGGGGGGGGGGOOOOOOS
OOOOOOWWWWWWWWWWWSSSSGTTTTTTGGTTTTTTTTTGGGGGTTTTTGGTTTTGTTTTGGGGGTTTTTGTTGGGGGGGGGGGGGGGGGOOOOOOS
OOOOOOWWWWWWWWWWWSSSGTTTTTTTTTTTTTTTTGGGGGGTTTTTTTTTTTTTTTTGGGGGGTTTTTTTTGTTGGGGGGGGGGGGGGOOOOOOW
OOOOOOWWWWWWWWWWWSSSTTTTTTTTTTTTTTGTTGGGGGGGTTTTTTTTTTTTTTTGGGGGGGTTTTTTTGTTTGGGGGTGGGGGGGOOOOOOW
OOOOOOWWWWWWWWWWWWSTTTTTTTTTTTGTGGGGGGGGGGGTTTTTTTTTTTTTTTGGGGGGGGGTTTTTTTTTGGTGGGTTGGGGGGOOOOOOW
OOOOOOWWWWWWWWWWWSSSTTTTTTTTTTGGGGGGGGGGGGGGTTTTTTTTTTTTTTGGGGGGGGGGTTTTTTTTTTTTTTTTTTTGGTOOOOOOW
OOOOOOWWWWWWWWWWWSSSSTTTTTTTTTGGGGGGGGGGGGGGTTTTTTTTTTTTGGGGGGGGGGGTTTTTTGTTTTTTTTTTTTTTTSOOOOOOW
OOOOOOWWWWWWWWWWSSSSSSGTTTTTTTGGGGGGGGGGGGGGGTTTTTTTTTTTTGGGGGGGGGTTTTTTTTTTTTTTTTTTTTTSSSOOOOOOW
OOOOOOWWWWWWSWSSSSSSTTTTTTTTTGGGGGGGGGGGGGGGGTTTGGGTTTTTTGGGGGGGGTTTTTTTTGTTTTTTTTTTTTTTSWOOOOOOW
OOOOOOWWWWWSSSSSSSSSTTSTTTTTTTGGGGGGGGGGGGGGGTTTTGGGGTTTTGGGGGGGGGTTTTTTTTTTTTTTTTTTTGGTSWOOOOOOW
OOOOOOWWWWSSSSSSSSSSSSSTTTTTTGGGGGGGGGGGGGGTTTTTGGGGGTTTGGGGGGGGGTTTTTTTTTGTTTTTTTTTTGGGWWOOOOOOW
OOOOOOWWSSSSSSGGGSSSSSSGTTTTTTGGGGGGGGGGGGGTTTTGGGGGGTTTTGGGGGGGGTTTTTTTGGTTTTTTTTTTGGGGWWOOOOOOW
OOOOOOSSSSSSGTGGGSSSSSSGTTTTTTGGGGGGGGGGGGGTTTGGGGGGGGTTGGGGGGGGGGGGTTTTGGGTTTTGTTTTTGGGSWOOOOOOW
OOOOOOSSSGGGTTTTGSSSSSSSGGTTTTTGGGGGGGGGGGGGGGGGGGGGGGGGGGGGGGGGGGGGGTTTGGGGTGGGTTTTGGGGSSOOOOOOW
OOOOOOSSGTGTTTTTGGSSSSSSSGTTTTTTGGGGGGGGGGGGGGGGGGGGGGGGGGGGGGGGGGGGGGTGGGGGGGGGGGTGGGGGSSOOOOOOW
OOOOOOSSTTTTTTTTTGSSSSSSSSGGTTTTTGGGGGGGGGGGGGGGGGGGGGGGGGGGGGGGGGGGGGGGGGGGGGGGGGGGGGGSSSOOOOOOW
OOOOOOSTTTTTTTTTTTTTSSSSSSSTTTTTTGGGGGGGGGGGGGGGGGGGGGGGGGGGGGGTGGGGGGGGGGGGGGGGGGGGGGGSSWOOOOOOW
OOOOOOSSTTTTTTTTTTTGSSSSSSSTTTTTTGGGGGGGTGGGGGGGGGGGGGGSSSGGGTTTTGGGGGGGGGGGGGGGGGGGGGGSWWOOOOOOW
OOOOOTSSGTTTTTTTTTGGGGSSSSSTTGTGGGGGGGTTTGGGGGTGGGGSSSSSSSSGGTTTTGGTGGGGGGGGGGGGGGGGGGSSWWOOOOOOW
OOOOOOTTGGTTTTTTTGGGGGGSSSSSSGGGGGGGGGTTTTTGGTTTGGSSSSSSSSSSGTTTTTTTTGGGGGGGGGGGGGGGGGSSWWOOOOOOW
OOOOOOWTTTTTGGTTGGGGGGGGSSSSSSSSGSGGGGTTTTTTTTTGGSSSSSSSSSSSGTTTTTTTTTGGGGGGGGGGGGGGGGSSSWOOOOOOW
OOOOOOWGGTTGGGGGGGGGGGGGSSSSSSSSSSSSSGGGTTTTTTTGGSSSGGGSSSSSSGGTGTTTTGGGGGGGGGGGGGGGGGSSSWOOOOOOW
OOOOOOWSGGTTGGGGGGGGGGGGGSSSSSSSSSSSSSGGTTTTTTTGGSSGGGGSSSSSSTSTGGTTGGGGGGGGGGGGGGGGGGSSSSOOOOOOW
OOOOOOWSGTTGGGGGGGGGGGGGGSSSSSSSSSSSSSSGGTTTTTGGSSGGGGGSSSSSSSSSSSGGGGGGGGGGGGGGGGGGGGGSSSOOOOOOW
OOOOOOWSGGTTGGGGGGGGGGGGGSSSSSSSSSSSSSSSSGTGTTGGSSGGGGSSSSSSSSSSSSSGGGGGGGGGGGGGGGGGGGGTGGOOOOOOW
OOOOOOSSGGGTTGGGGGGGGGGGGSSSSSSSSSSSSSSSSSGTGSSSSSGGGGSSSSSSGSSSGSSSGGGGGGGGGGGGGGGGGGTTGTOOOOOOW
OOOOOOSSGGGTTTTGGGGGGGGGGGSSSSSSSSSSSSSSSSSSSSSSSSSSSSSSSSGGGGGGGGGGGGGGGGGGGGGGGGGGGTTTTTTOOOOOW
OOOOOOSSSGTTTTTGGGGGGGGGGGGSSSSSSSWWSSSSSSSSSSSSSSSSSSSSSGGGGGGTGGGGGGGGGTTGTGGGGGGGGGTTTTOOOOOOW
OOOOOOWSGGGTTTTGGGGGGGGGGGGGGSSSSSWWSSSSSSSSSSSSSSSSSSSTGTGGGTTTTGGGGGGTTTTTTTTTGGGGGTTTTGOOOOOOW
OOOOOOWWTTGGTGGGGGGGGGGGTTGTGGSSSSWWWSSSSSSSSSSSSSSSSSSTTTTTGTTTTTGGGGGTTTTTTTTTTTTGTTTTTTOOOOOOW
OOOOOOWWTTGGGGGGGGGGGGGGTTTGTGSSSSSWSSSSSSSSSSSSSSSSSSGGTTTTTTTTTTGGGGGTTTTTTTTTTTTTTTTTGTOOOOOOW
OOOOOOWWWSTGGGGGGGGGGGGTTTTGGGSSSSSSSSSSSSSSSSSSSSSSSGGGTTTTTTTGTTTTGGGGGGTTTTTTTTTTTTTTTTOOOOOOW
OOOOOOWWSSSSGGGGGGGGGGGGTTTTGGSSSSSSSSSSSSSSSSSSSSSSGGGGGTTTTTGGGGTGGGGGGGTTTTTTTTTTTTTTTTOOOOOOW
OOOOOOWWSSSSGGGGGGGGGGGGTTTTGGTSSSSSSSSGSSSSSSSSSSSSGGGGGGGTTTGGGGGGGGGGGGGGGTTTTTTTTTTTTTOOOOOOW
OOOOOOWSSSSSGGGGGGGGGGGGGTTTGTSSSSSSSSGGGGGGGGSSSSSSGGGGGGGGTTTGGGGGGGGGGGGGTTTTTTTTTTTTTGOOOOOOW
OOOOOOSSSSSGGGGGGGGGGGGGGGGGSTSSSSSSSSGTGGGGGGGSSSSSGGGGGGGGGTTGGGGGGGGGGGGGGTTTGTTTTTTTTTTOOOOOW
OOOOOOSSSGGGGGTGGGGGGGGGGGGGSSSSSSSSSSSGGGGGGGGGSSSSGGGGGGGGGGGGGGGGGGGGGGGGTTGGGGTTTTTTTTOOOOOOW
OOOOOOSSGGGTGTTTTGGGGGGGGGGGSSSSSSSSSSSSGGGGGTGSSSSSSGGGGGGGGGGGGGGGGGGGGGGGGGGGGGGGTTTTTTTOOOOOW
OOOOOOSSGTTTTTTTTTGGGGGGGGGGSSSSSSSSSSSSSGGGGGGSSSSSSTTTGGGGGGGGGGGGGGGGGGGGGGGGGGGGGGGTTTOOOOOOW
OOOOOOSGGTTTTTTTTTTTGGGGGGGGGSSSSSSSSSSSSSSSSSSSSSSSSSTTTGGGGGGGGGGGGGGTTGGGGGGGGGGGGGGGTTTOOOOOW
OOOOOOSGTTTTTTTTTTTTTTGGGGGGGSSSSSSSSSSSSSSSSSSSSSSSSSTTGGGGGGGGGGGGGGGTTTGGGGGGGGGGGGGTTGOOOOOOW
OOOOOOGTTTTTTTTTTTTTTTTTTGGGGSSSSSSSSSSSSSSSSSSSSSSSSTTSTGGGGGGGGGGGGGGTTGGGGGGGGGGGGGGGTTOOOOOOW
OOOOOOTTTTTTTTTTTTTTTTTTTGGGGSSSSSSSSSSSSSSSSSSSSSSSSSTSSGGGTTTTGGGGGGGGGGGGGGGGGGGGGGGGTTOOOOOOW
OOOOOTGTTTTTTTTTTTTTTTTTTGGGSSSSSSSSSSSSSSSSSSSSSSSSSSSSSSSGTTTTTTTGGGGGGGGGGGGGGGGGGGGGGTOOOOOOW
OOOOOTTGTTTGGGGGTTTTTTTGGGGGSSSSSSSSSSSSSSSSSSSSSSSSSSSSSSSGTTTTTTTGGGGGGGGGGGGGGGGGGGGGGSOOOOOOW
OOOOOTTGGTTTGGGGGGTGGTTGGGGGGSSSSSSSSSSSSSSSSSSSTSSSSSSSSSSSSGGTTTTGGGGGGGGGGGGGGGGGGGGGGWOOOOOOW
OOOOOOSSGTTGGGGGGGGGGGGGGGGGSSSSSSSSSSSSSSSSSSSTSSSSSSSSSSSSSSSTTTGGGGGGGGGGGGGGGGGGGGGGWWOOOOOOW
OOOOOOSSGGGTGGGGGGGGGGGGGGGGSSSSSSTGGSSSSSSSSSSSSSSSSSSSSSSSSSSSGGGGGGGGGGGGGGGGTGGGGGGSSWOOOOOOW
OOOOOOSSGGGGGGGGGGGGGGGGGGGGSSSSTTTTGGGSSSSSSSSSSSSSSSSSSSSSSSSGGGGGGGGGGGTTTGGTTTTTTGGSSWOOOOOOW
OOOOOOSSGGGGGGGGGGGGGGGGGGGGSSSGTTTTTGGGGSSSSSSSSSSSSSSSSSSSSSSGGGGGGGGGGTTTTGTTTTTGTTGSSWOOOOOOW
OOOOOOSSGGGGGGGGGGGGGGGGGGGGGGGTTTTTTGGGGGSSSSSSSSSSSSSSSGGSSSSGGGGGGGGGGGTTTTTTTTTGTTGGSWOOOOOOW
OOOOOOSSGGGGGGGGGGGGGGGGGGGGGGTTTTTTTTTGGTGGSSSSSSSSSSSSSGGSSSSGGGGGGGGGTTTTTTTTTTGGTTTGSSOOOOOOW
OOOOOOSSGGGGGGGGGGGGGGGGGGGGGTTTTTTTTTTTTTTGGGSSSSSSSSTSTSSSSSSSGGGGGGGTTTTTTTTTTTTTTTGGSSOOOOOOW
OOOOOOSSGGGGGGGGGGGGGGGGGGGGGGTTTTTTTTTTTTTTGGGSSSSSSSTTSSSSSSSSGGGGGGGTTTTTTTTTTTTGTTGGSSOOOOOOW
OOOOOOSSTGGTGGGGGGGGGGGGGGGGGGGTTTTGTGGTTTTTGGGGSSSSSSSSSSSSSSSSGGGGGGGGGTTTTTTTTTTTTTGGSSOOOOOOW
OOOOOOSTTTTGGGGGGGGGGGGGGGGGGGGGGTTGGGGGGTTTTTGGSSSSSSSSSSSSSSSSGGGGGGGGGGTTTTTTTTTTTTGTSSOOOOOOW
OOOOOOTTTTTGGGGGGGGGGGGGGGGGGGGGGGGGGGGGGGTTTTGGGSSSSSSSSSSSSSSSGGGGGGGGGGTTTTTTTGTTTTTTTGOOOOOOW
OOOOOOSTTTTGGGGGGGGGGGGGGGGGGGGGGGGGGGGGGGGGGTTGGSSSSSSSSSSSSSSGGGGGGGGGGGTTTTTGGGTTTTTTTGOOOOOOW
OOOOOOSSTTTGGGGGGGGGTGGGTTGGGGGGGGGGGGGGGGGGGGGGGSSSSSSSSSSSSSGGGGGGGGGGGTTTTTTTGGGGTGGGGGOOOOOOW
OOOOOOGSSTGGGGGTTTGTTTTGTTTGGGGGGGGGGGGGGGGGGGGGGSSSSSSSSSSSSGGGTTGGGGGGTTTTGTTGGGGGGGGGGGOOOOOOW
OOOOOOGGGGGGGGTTTGTTTTTTTTTGGGGGGGGGGGGGGGGGGGGGGSSSSSSSSSSSSGGGTTTGGGGGGTTGGGGGGGGGGGGGGGOOOOOOW
OOOOOOGGGGGGGGTTTGTTTTTTTTTTGGGGGGGGGGGGGGGGGGGGGSSSSSSSSSTSGTTTTTGGGGGGGGGGGGGGGGGGGGGGGGOOOOOOW
OOOOOOGGGGTTTTTTTTTTTTTTTTTGGGGGGGGGGGGGGGGGGGGGGSSSSSSSSSSTTGTTTTTGGGGGGGGGGGGGGGGGGGTTGSOOOOOOW
OOOOOOGGGGGTTTTTTTTTTTTTTTGGGGGGGGGGGGGGGGGTTTGGGSSSSSSSSSTSGTTTTTGGGGGGGGGGGGGGGGGGGGGTGGOOOOOOW
OOOOOOGGGGGTTTTTTTTTTTTTTGGGGGGGGGGGGGGGGTTTTTGGSSSSSSSSSSSGTTTTTTGGGGGGGGGGGGGGGGGGGGTTTGOOOOOOW
OOOOOOGGGGGGTTTTTTTTTTTTTGGGGGGGGGGGGGGGGTTTTGGSSSSSSSSSSSSTTTTTTTGGGGGGGGGGGGGGGGGGGGGTTGOOOOOOW
OOOOOOGGGGTTTTTTTTTTTTTGTGGGGGGGGGGGGGGGGTTTGSTSSSSSSSSSSSSGTTTTTTGGGGGGGGGGGGGGGGGGGGGGGGOOOOOOW
OOOOOOGGGGGTTTTTTTGTTTTGGGGGGGGGGGGGGGGGGTTTGTSSSSSSSSSSSSSSGTTTTTGGGGGGGGGGGGGGGGGGGGGGGGOOOOOOW
OOOOOOGGGTTTTTTTGGGGTGGGGGGGGGGGGGGGGGTTTTTTTGSSSSSSSSSSSSSSSTTTTTTGGGGGGGGGGGGGGGGGGGGGGGOOOOOOW
OOOOOOGGGTGTTTTTGGGGGGGGGGGGGGGGGGGGGTTTTTGGTGSSSSSSSSSSSSSTSTTTTTGGGGGGGGGGGGGGGGGGGGGTGGOOOOOOW
OOOOOOGGGGGGTTGGGGGGGGGGGGGGGGGGGGGGGGTTTTSSSSSSSSSSSTGSSSSSSGGTTGGGGGGGGGGGGGGGGGGGGGTTGGOOOOOOW
OOOOOOTGGGGGGGGGGGGGGGGGGGGGTTGGSSSSSSSTGGSSSSSSSSSSTTGGSSSSTTTTGGGGGGGGGGGTTGGGGGGGGGTTTGOOOOOOW
OOOOOOGGGGGGGGGGGGGGGGGGGGGTTTTGSSSSSSSSSSSSSSSSSSSSSSGSSSSSTSTTGGGGGGGGGGTTTTGGGGGGGGTTGGOOOOOOW
OOOOOOTGGGGGGGGGGGGGGGGGGTTTTTGGSSSSSSSSSSGGSSSSSSSSSSSSSSSSSSGGGGGGGGGGGTTTTTTGGGGGGGGGGGOOOOOOW
OOOOOOTGGGGGGGGGGGGGGGGGGTTTTTTGSSSSSSSSSGGTGGSSSSSSSSSSSSSSSSGGGGGGGGGGTTTTTTGGTTTGTTGGGGOOOOOOW
OOOOOOGGGGGGGGGGGGGGGGGGGTTTTGTGSSSSSSSSSSGGGGGGGSSSSSSSSSSSSGGGGGGGGGGGTTTTTTTTTTTTTTTTGGOOOOOOW
OOOOOOGGGGGGGGGGGGGGGGGGGGGTTTTGSSSSSSGSSSTGGGGGGGSSSSSSSSSSSGGGGGGGGGGTTTTTTTTTTTTTTTTTGGOOOOOOW
OOOOOOGGGGGGGGGGGGGGGGGGGGGGGGGSSSSSSGGGSSSGGGGGGGGSSSSSSSSSSGGGGGGGGGGGTTTTTTTTTTTTTTTTGSOOOOOOW
OOOOOOGTTGGGGGGGGGGGGGGGGGGGGGGSSSSSSSGSSSSGGGGGGGGGSSSSSSSSSGGGGGGGGGGGGGTTTTTTTTTTTTGGGSOOOOOOW
OOOOOOGGTGGGGGGGGGTGGGGGGGGGGGGGSSSSSSSSSSSSSGGGGGTGSSSSSSSSSGGGGGGGGGGGGGGTTTTTTTTTTTGGSSOOOOOOW
OOOOOOGGGGGGGGGGTTTTGGGGGGGGGGGGSSSSSSSSSSSSSSSSGGGSSSSSSSSSSSGGGGGGGGGGGGGGTTTTGTTTTGGGSSOOOOOOW
OOOOOOGGGTTGGGGGTTTTTGGGGGGGGGGGSSSSSSSSSSSSSSSSSSSSSSSSSSSSSSSSSSSGGGGGGGGGGGTGGGGTTGGGSSOOOOOOW
OOOOOOGTTTTGGGTTTTTTTGGGGGGGGGGGGSSSSSSSSSSSSSSSSSSSSSSSSSSSSSSSSSGGTGGGGGGGGGGGGGGGGGGGSSOOOOOOW
OOOOOOGGGTTTTTTTTTTTTTTGGGGGGGGGGGSSSSSSSSSSGGSSSSSSSSSSSSSSSSSSSSGTTTTGGGGGGGGGGGGGGGGGGSOOOOOOW
OOOOOOGGGTTTTTTTTTTTTGGGGGGGGGTGGGSSSSSSSSSGGTGTTSSSSSSSTSTSSSSSSGTTTTTGGGGGGGGGGGGGGGGGGSOOOOOOW
OOOOOOGGTTTTTTTTTTTTTGGGGGGGGTTTTTSSSSSSSSGTTTTTTSSSSSSSSTSSSSSSSGGTTTTGGGGGGGGGGGGGGGGGSSOOOOOOW
OOOOOOGGTTTTTTTTTTTTTGGGGGGGTTTTTTSSSSSSTGGTTTTTGTSSSSSSSSSSSSSSTGTGTTTTGGGGGGGGGGGGGTTGSSOOOOOOW
OOOOOOGGTTTTTTTTTTTTTTGGGGGGGTTTTGGSSSSSSGTTTTTTTTSSSSSSSSSSSSSGGTGTTTTTTGGGGGGGGTTGTTTTTSOOOOOOW
OOOOOOGTTTTTTTTTTTTTTTGGGGGGGGTGGGGSSSSSGTTTTTTTTTSSSSSSSSSSSSSGTTTTTTTTGGGGGGGGTTTTTTTTTSOOOOOOW
OOOOOOGGTTTTGTTTGGTTTTTGGGGGGGGGGGGGGGGGTTTTTTTTTGSSSSSSSSSSSSSGGTTTTTTTGGGGGGGGGTTTTTTTTSOOOOOOW
OOOOOOGGGTTGGGGGGGTTTTTGGGGGGGGGGGGGGGGGGTTTTGGTGGSSSSSSSSSSSSSGGTTTTTTGGGGGGGGGGTTTTTTTSSOOOOOOW
OOOOOOGGGTTGGGGGGGGTTTTGGGGGGGGGGGGGGGGGGGTGGGGGGGGGGGGGSSSSSSSGGGGTGGGGGGGGGGGGGGTTTTTTTTOOOOOOW
OOOOOOGGTTTGGGGGGGGGTGGGGGGGGGGGGGGGGGGGGGGGGGGGGGGGGGGGGGSSSSGGGGGGGGGGGGGGGGGGGGGTTTTTTTOOOOOOW
OOOOOOGGTTGGGGGGGGGGGGGGGGGGGGGGGGGGGGGGGGGGGGGGGGGGGGGGGGGSSGGGGGGGGGGGGGGGGGGGGGGGGGTTTTOOOOOOW
OOOOOOGGGGGGGGGGGGGGGGGGGGGGGGGGGGGGGGGGGGGGGGGGGGGGGGGGGGGGGGGGGGGGGGGGGGGGGGGGGGGGGGTTTSOOOOOOW
OOOOOOGGGGGGGGGGGGGGGGGGGGGGGGGGGGGGGGGGGGGGGGGGGGGGGGGGGGGGGGGGGGGGGTGGGGGGGGGGGGGGGGGTTSOOOOOOW
OOOOOOGGGGGGGGGGGGGGGGGGGGGGGGGGGGGGGGGGGGGGGGGGGGGGGGGGGGGGGGGGGGGTTTTGGGGGGGGGGGGGGGTTTSOOOOOOW
OOOOOOGGGGGGGGGGGGGGGGGGGGGGGGGGTGGGGGGGGGGGGGGGGGGGGGGGGGGGGGGGGGTTTTTGGGGGGGGGGGGGGGGTTSOOOOOOW
OOOOOOGGGGGGGGGGGGGGGGGGGGTGGGGTTTGGGGGGGGGGGGGTGGGGTGGGGGGGGGGGTTTTTTGGGGGGGGGTGGGGGGGTTSOOOOOOW
OOOOOOGGGGGGGGGGGGGGGGGGGTTTGGGGTTGGGGGGGGGGGTTTTGTTTTGGGGGGGGGGTTTTTTTGGGGGGGTTTTGGGTTTTSOOOOOOW
OOOOOOGGGGGGGGGGGGGGGGGGGTTTGGGTTGGGGGGGGGGGGTTTTTTTTTTGGGGGGGGGTTTTTGGGGGGGGTTTTTGTTTTTSSOOOOOOW
OOOOOOGGTGGGGGGGGGGGGGGGGGTTTTTTTGGGGGGGGGGGTTTTTTTTTTGGGGGGGGGGGGTTTTGGGGGGGGTTTTTTTTTTSWOOOOOOW
OOOOOOGTTGGGGGGGGGGGGGGGGGTTTTTTGGGGGGGGGGGTTTTTTTTTTGGGGGGGGGGGGTTTTTTGGGGGGGGTTTTTTTGTSWOOOOOOW
OOOOOOGGGTTGGGGGGGGGGGGGGGTTTTTTTGGGGGGGGGTTTTTTTTTTGGGGGGGGGGGGGGTTTTTTGGGGGGGGTTTTTTGTSSOOOOOOW
OOOOOOGGGGGGGGGGGGGGGGGGTTTTTTTTGGGGGGGGGGGTTTTTTTTTGGGGGGGGGGGGGGGGTTTTTGGGGGGGGTTTGGSWWWOOOOOOW
OOOOOOGGGGGGGGGGGGGGGGGTTTTTTTTTTGGGGGGGGGGTTTTTTTTGGGGGGGGGGGGGGGGTTTTTTTGGGGGGGGGGGSWWWWOOOOOOW
OOOOOOGGGGGGGGTTGGGGTTTTTTTTTTTTGGGGGGGGGGTTTTTTTTTGGGGGGGGGGGGGGGGGTTTTTGGGGGGGGGGTSWWWWWOOOOOOW
OOOOOOTGGGGGTTTTTGGTTTTTTTTTTTTGGGGGGGGGGTTTTTTTTTGGGGGGGGGGGGGGGGGGGTTTTTGGGGGGGSSSSWWWWWOOOOOOW
OOOOOOGGTGGGTTTTTTTTTTTTTTTTTTTTGGGGGGGGGTTTTTTTTTTGGGGGGGGGGGGGGGGGTTTTTGGGGGGSSWSSWWWWWWOOOOOOW
OOOOOOGGGGGGGTTTTTTTTTGGTTTTTTTTTGGGGGGGTTTTTTTTTTGGGGGGGGGGGGGGGGGGTTTTTGGGTGSSWWWWWWWWWWOOOOOOW
OOOOOOGTGTGGGTTTTTTTTGGGGTTTTTTTGGGGGGGGTTTTTTTTTTTGGGGGGGGGGGGGGGGGTTTTGGGGGSSSWWWWWWWWWWOOOOOOW
OOOOOOTGGGGGGTTTTTTTTTGGGGGTTTGGGGGGGGGGTTTTTTTTTTGGGGGGGGGGGGTTGGGTTTGGGGGGSSWWWWWWWWWWWWOOOOOOW
OOOOOOGGGTGGGGGGGGTTTGGGGGGGTGGGGGGGTTTTGTTTGTGGGGGTGGGGGGGGGGTTTTGGSTGSSSWSSWWWWWWWWWWWWWOOOOOOW
OOOOOOGGGGGGGGGGGGGGGGGGGGGGGGGGGGGGGGGGGGGGGGGGGGGGGGGGGGGGGTTTTGSSWWWWSWWWWWWWWWWWWWWWWWOOOOOOW
OOOOOOOOOOOOOOOOOOOOOOOOOOOOOOOOOOOOOOOOOOOOOOOOOOOOOOOOOOOOOOOOOOOOOOOOOOOOOOOOOOOOOOOOOOOOOOOOW
OOOOOOOOOOOOOOOOOOOOOOOOOOOOOOOOOOOOOOOOOOOOOOOOOOOOOOOOOOOOOOOOOOOOOOOOOOOOOOOOOOOOOOOOOOOOOOOOW
OOOOOOOOOOOOOOOOOOOOOOOOOOOOOOOOOOOOOOOOOOOOOOOOOOOOOOOOOOOOOOOOOOOOOOOOOOOOOOOOOOOOOOOOOOOOOOOOW
OOOOOOOOOOOOOOOOOOOOOOOOOOOOOOOOOOOOOOOOOOOOOOOOOOOOOOOOOOOOOOOOOOOOOOOOOOOOOOOOOOOOOOOOOOOOOOOOW
