type octile-corner
height 97
width 97
map
1111111111111111111111111111111111111111111111111111111111111111111111111111111111111111111111111
1111111111111111111111111111111111111111111111111111111111111111111111111111111111111111111111111
1111111111111111111111111111111111111111111111111111111111111111111111111111111111111111111111111
1111111111111111111111111111111111111111111111111111111111111111111111111111111111111111111111111
1111111111111111111111111111111111111111111111111111111111111111111111111111111111111111111111111
1111111111111111111111111111111111111111111111111111111111111111111111111111111111111111111111111
1111111111111111111111111111111111111111111111111111111111111111111111111111111111111111111111111
1111111111111111111111111111111111112121111111111111111111111111111111111111111111111111111111111
1111111111111111111111111112111111121222212221222122221111111111111111111111111111111111111111111
1111111111111111111111111122111111122222222222222222222221221111111111111111111111111111111111111
1111111111111111111111111222111111222222222222222222222222222111111111111111111112211111111111111
1111111122222111111121222222211212222222222222222222222222222111112211111111111122221111111111111
1111111222222211111222222222222222222222222222222222222222222122222221112111112222221111111111111
1111111222222211122222222222222222222222222222222222222222222222222222112112112222222111111111111
1111112222222221222222222222222222222222222222222222222222222222222222222222122222222111111111111
1111112222222222222222222222222222222222222222222222222222222222222222222222222222222111111111111
1111112222222222222222222222222222222222222222222222222222222222222222222222222222222111111111111
1111112222222222222222222222222222222222222222222222222222222222222222222222222222221111111111111
1111111222222222222222222222222222222222222222222222222222222222222222222222222222211111111111111
1111111222222222222222222222222222222222222222222222222222222222222222222222222222211111111111111
1111111112222222222222222222222222222222222222222222222222222222222222222222222222111111111111111
1111111112222222222222222222222222222222222222222222222222222222222222222222222222221111111111111
1111111112222222222222222222222222222222222222222222222222222222222222222222222222221111111111111
1111111112222222222222222222222222222222222222222222222222222222222222222222222222222111111111111
1111111122222222222222222222222222222222222222222222222222222222222222222222222222222111111111111
1111111122222222222222222222222222222222222222222222222222222222222222222222222222221111111111111
1111111222222222222222222222222222222222222222222222222222222222222222222222222222222111111111111
1111111222222222222222222222222222222222222222222222222222222222222222222222222222222211111111111
1111111222222222222222222222222222222222222222222222222222222222222222222222222222222111111111111
1111111222222222222222222222222222222222222222222222222222222222222222222222222222222111111111111
1111112222222222222222222222222222222222222222222222222222222222222222222222222222211111111111111
1111111222222222222222222222222222222222222222222222222222222222222222222222222222121111111111111
1111111222222222222222222222222222222222222222222222222222222222222222222222222221111111111111111
1111111222222222222222222222222222222222222222222222222222222222222222222222222222111111111111111
1111111122222222222222222222222222222222222222222222222222222222222222222222222211111111211111111
1111111122222222222222222222222222222222222222222222222222222222222222222222222222111111111111111
1111111222222222222222222222222222222222222222222222222222222222222222222222222221111111111111111
1111111112222222222222222222222222222222222222222222222222222222222222222222222221112111111111111
1111111112222222222222222222222222222222222222222222222222222222222222222222222222211111111111111
1111111111222222222222222222222222222222222222222222222222222222222222222222222222221111111111111
1111111111122222222222222222222222222222222222222222222222222222222222222222222222211111111111111
1111111111122222222222222222222222222222222222222222222222222222222222222222222222222111111111111
1111111111122222222222222222222222222222222222222222222222222222222222222222222222221111111111111
1111111111112222222222222222222222222222222222222222222222222222222222222222222222221111111111111
1111111111122222222222222222222222222222222222222222222222222222222222222222222222211111111111111
1111111111122222222222222222222222222222222222222222222222222222222222222222222222212111111111111
1111111111122222222222222222222222222222222222222222222222222222222222222222222222212211111111111
1111111111222222222222222222222222222222222222222222222222222222222222222222222222221111111111111
1111111112222222222222222222222222222222222222222222222222222222222222222222222222221111111111111
1111111122222222222222222222222222222222222222222222222222222222222222222222222222221111111111111
1111111222222222222222222222222222222222222222222222222222222222222222222222222222222111111111111
1111111122222222222222222222222222222222222222222222222222222222222222222222222222221111111111111
1111111222222222222222222222222222222222222222222222222222222222222222222222222222212111111111111
1111111222222222222222222222222222222222222222222222222222222222222222222222222222211111111111111
1111111222222222222222222222222222222222222222222222222222222222222222222222222222222111111111111
1111112222222222222222222222222222222222222222222222222222222222222222222222222222222111111111111
1111112222222222222222222222112222222222222222222222222222222222222222222222222222222111111111111
1111122222222222222222222222211221222222222222222222222222222222222222222222222222221111111111111
1111112222222222222222222222211111222222222222222222222222212222222222222222222222211111111111111
1111111222222222222222222222222221122222222222222222222222222222222222222222222222211111111111111
1111111122222222222222222222222222222222222222222222222122122222222222222222222222211111111111111
1111111122222222222222222222222222222222222222222222222222222222222222222222222222111111111111111
1111111122222222222222222222222222222222222222222222222222222222222222222222222222111111111111111
1111111112222222222222222222222222222222222222222222222222222222222222222222222222211111111111111
1111111122222222222222222222222222222222222222222222222222222222222222222222222222221111111111111
1111111122222222222222222222222222222222222222222222222222222222222222222222222222221111111111111
1111111122222222222222222222222222222222222222222222222222222222222222222222222222221111111111111
1111111112222222222222222222222222222222222222222222222222222222222222222222122222221111111111111
1111111111222222222222222222222222222222222222222222222222222222222222222122222212211111111111111
1111111111122222222222222222222222222222222222222222222222222222222222222222211111111111111111111
1111111111122222222222222222222222222222222222222222222222222222222222222222111111111111111111111
1111111111122222222222222222222222222222222222222222222222222222222222222221111111111111111111111
1111111111112222222222222222222222222222222222222222222222222222222222222211111111111111111111111
1111111111122222222222222222222222222222222222222222222222222222222222222211111111111111111111111
1111111111122221222222122222222222222222222222222222222222222222222222222211111111111111111111111
1111111111121111111211122222222222222222222222222222222222222222222222212111111111111111111111111
1111111111211111111111222222222222222222222222222222222222222222222222222211111111111111111111111
1111111111111111111112222222222222222222222222222222222222222222222212222111111111111111111111111
1111111111111111111111212222222222222222222222222222222222222222222222221111111111111111111111112
1111111111111111111111111222222222222222222222222222222222222222222222222111111111111111111111122
1111111111111111111111111222222222222222222222222222222222222222222222221111111111111111111111222
1111111111111111111111111122222222222222222222222222222222222222222222211111111111111111111222222
1111111111111111111111111112222222222222222222222222222222222222222212122111111111111111111222222
1111111111111111111111211111112221122222222222222222222222222222222211221111111111111111112222222
1111111111111111111111111111111221122222222222222222222222222222222211112111111111111111111122222
1111111111111111111111111111112211222222222222222222222221122222222121121111111111111111111112222
1111111111111111111111111111211111111222222222222222222211122222111111111111111111111111111111222
2111111111111111111111111111111111111122122222222222222211111221111111111111111111111111111111122
2111111111111111111111111111111111111111111222122222222221111111111111111111111111111111111111122
2111111111111111111111111111111111111111111221112222222222111111111111111111111111111111111111122
2111111111111111111111111111111111111111111111111122222221111111111111111111111111111111111111112
1111111111111111111111111111111111111111111111111122222221111111111111111111111111111111111111122
2111111111111111111111111111111111111111111111111112222121111111111111111111111111111111111111122
2111111111111111111111111111111111111111111111111111121111111111111111111111111111111111111111122
2111111111111111111111111111111111111111111111111111111111111111111111111111111111111111111111222
2211111111111111111111111111111111111111111111111111111111111111111111111111111111111111111112222
2221111111112111111111111111111111111111111111111121111111111111111111111211111111111111111122222
WWWWWWWWWWWWWWWWWWWWWWWWWWWWWWWWWWWWWWWWWWWWWWWWWWWWWWWWWWWWWWWWWWWWWWWWWWWWWWWWWWWWWWWWWWWWWWWWW
OOOOOOOOOOOOOOOOOOOOOOOOOOOOOOOOOOOOOOOOOOOOOOOOOOOOOOOOOOOOOOOOOOOOOOOOOOOOOOOOOOOOOOOOOOOOOOOOW
OOOOOOOOOOOOOOOOOOOOOOOOOOOOOOOOOOOOOOOOOOOOOOOOOOOOOOOOOOOOOOOOOOOOOOOOOOOOOOOOOOOOOOOOOOOOOOOOW
OOOOOOOOOOOOOOOOOOOOOOOOOOOOOOOOOOOOOOOOOOOOOOOOOOOOOOOOOOOOOOOOOOOOOOOOOOOOOOOOOOOOOOOOOOOOOOOOW
OOOOOOOOOOOOOOOOOOOOOOOOOOOOOOOOOOOOOOOOOOOOOOOOOOOOOOOOOOOOOOOOOOOOOOOOOOOOOOOOOOOOOOOOOOOOOOOOW
OOOOOOOOOOOOOOOOOOOOOOOOOOOOOOOOOOOOOOOOOOOOOOOOOOOOOOOOOOOOOOOOOOOOOOOOOOOOOOOOOOOOOOOOOOOOOOOOW
OOOOOOOOOOOOOOOOOOOOOOOOOOOOOOOOOOOOOOOOOOOOOOOOOOOOOOOOOOOOOOOOOOOOOOOOOOOOOOOOOOOOOOOOOOOOOOOOW
OOOOOOOOOOOOOOOOOOOOOOOOOOOOOOOOOOOOOOOOOOOOOOOOOOOOOOOOOOOOOOOOOOOOOOOOOOOOOOOOOOOOOOOOOOOOOOOOW
OOOOOOOOOOOOOOOOOOOOOOOOOOOOOOOOOOOOOOOOOOOOOOOOOOOOOOOOOOOOOOOOOOOOOOOOOOOOOOOOOOOOOOOOOOOOOOOOW
OOOOOOWWWWWWWWWWWWWWWWWWWWSSWWWWWWWSSSSSSSSSSSSSSSSSSSSSSWSSWWWWWWWWWWWWWWWWWWWWWWWWWWWWWWOOOOOOW
OOOOOOWWWWWWWWWWWWWWWWWWWSSSWWWWWWSSSSSSSSGSTTTTTTSSSSSSSSSSSWWWWWWWWWWWWWWWWWWWWSSWWWWWWWOOOOOOW
OOOOOOWWSSSSSWWWWWWWSWSSSSSSSWWSWSSSSSGGGTTTTTTTTTTTTTGSSSSSSWWWWWSSWWWWWWWWWWWWSSSSWWWWWWOOOOOOW
OOOOOOWSSSSSSSWWWWWSSSSSSSSSSSSSSSSSSGGGGGGTTTTTTTTTTTTGSSSSSWSSSSSSSWWWSWWWWWSSSSSSWWWWWWOOOOOOW
OOOOOOWSSSSSSSWWWSSSSSSSSSSSSSSSSSSSSGGGGGGGGGGGGTTTTTTTSSSSSSSSSSSSSSWWSWWSWWSSSSSSSWWWWWOOOOOOW
OOOOOOSSSSSSSSSWSSSSSSSSSSSSSSSSSSSSTGGGGGGGGGGGGGTTTTTTSSSSSSSSSSSSSSSSSSSSWSSSSSSSSWWWWWOOOOOOW
OOOOOOSSSSSSSSSSSSSSSSSSSSSSSSSSSSSTTGGGGGGGGGGGGGTTTTGSSSSSSSSSSSSSSSSSSSSSSSSSSSSSSWWWWWOOOOOOW
OOOOOOSSSSSSSSSSSSSSSSGGSSSSSSSSSSTTTGGGGGGGGGGGGGGTTGSSSSSSSSSSSSSSSSSSSSSSSSSSSSSSSWWWWWOOOOOOW
OOOOOOSSSSSSSSSSSSSSSTTTTGSSSGSSSSSTTGGGGGGGGGGGGGGGGSSSSSSSSSSSSSSSSSSSSSSSSSSSSSSSWWWWWWOOOOOOW
OOOOOOWSSSSSSSSSSSSSTTTTTTGTTGGSSSSTTGGGGGGGGGGGGGGGSSSSSSSSSSSSTGGSSSSSSSSSSSSSSSSWWWWWWWOOOOOOW
OOOOOOWSSSSSSSSSSSSSTTTTTTTTTGGGSSSSTTTGGGGGGGGGGGGSSSSSSSSSSSGGTTGGSSSSSSSSSSSSSSSWWWWWWWOOOOOOW
OOOOOOWWWSSSSSSSSSSTTTTTTTTTTTTTSSSSTTTGGGGGGGGGGGSSSSSSSSSSSGTTTTTTTTTSSSSSSSSSSSWWWWWWWWOOOOOOW
OOOOOOWWWSSSSSSSSTTTTTTTTTTTTTTTSSSSSSTTSGGGGGGGGSSSSSSSSSSGGGTTTTTTTTTSSGGSSSSSSSSSWWWWWWOOOOOOW
OOOOOOWWWSSSSSSSSTTTGGGTTGGGGGTTTGGSSTTSSGGGGGGGSSSSSSSSSSGGGGGGGGGGTTTTTTTGSSSSSSSSWWWWWWOOOOOOW
OOOOOOWWWSSSSSSSTTTTGGGGGGGGGGTTTGGGSSSSSSSTTTTSSSSSSGGGGGGGGGGGGGGGTTTTTTTGSSSSSSSSSWWWWWOOOOOOW
OOOOOOWWSSSSSSSSGTTTGGGGGGGGGGGTTTGGGSSSSSTTTTSTTSSSSGGGGGGGGGGGGGGGGTTTTTTTSSSSSSSSSWWWWWOOOOOOW
OOOOOOWWSSSSSSSTTTTTGGGGGGGGGGGTTTGGSSSSSSSTTTTTSSSSSGGGGGGGGGGGGGGGGGTTTTGGSSSSSSSSWWWWWWOOOOOOW
OOOOOOWSSSSSSSSTTTTTGGGGGGGGGGTTTTGGSSSSSSSSSSSSSSSSSGGGGGGGGGGGGGGGGGGTTTTTSSSSSSSSSWWWWWOOOOOOW
OOOOOOWSSSSSSSTTTTTGGGGGGGGGGGTTTTGSSSSSSSSSSSSSSSSSSGGGGGGGGGGGGGGGGGGGTTTTGGSSSSSSSSWWWWOOOOOOW
OOOOOOWSSSSSSGTTTTGGGGGGGGGGGTTTGSSSSSSSSSSSSSSSSSSTTGGGGGGGGGGGGGGGGGGGTTTTGTGSSSSSSWWWWWOOOOOOW
OOOOOOWSSSSSTTTTTGGGGGGGGGGGGGTTTSSSSSSSSSSSSSSSSSSSTTTTGGGGGGGGGGGGGGGGTTTTTTGSSSSSSWWWWWOOOOOOW
OOOOOOSSSSSSSTTGGGGGGGGGGGGGGGTTTTSSSSSSSSSSSSSSSSSSTTTTGGGGGGGGGGGGGGGGGGTTTTTSSSSWWWWWWWOOOOOOW
OOOOOOWSSSSSSTTGGGGGGGGGGGGGGGTTTTSSSSSSSSSSSSSSSSSSTTTTTGGGGGGGGGGGGGGGGTTTTTSSSSWSWWWWWWOOOOOOW
OOOOOOWSSSSSTTTGGGGGGGGGGGGGTTTTTTSSSSSSSSSSSSSSSSSSTTTTTGGGGGGGGGGGGGGGTTTTTSSSSWWWWWWWWWOOOOOOW
OOOOOOWSSSSSTTTGGGGGGGGGGGGGTTTTTTSSSSSSSSSSSSSSSSSSTTTTTGGGGGGGGGGGGGGGTTTTSSSSSSWWWWWWWWOOOOOOW
OOOOOOWWSSTTTTTGGGGGGGGGGGGGTTTTTSSSSSSSSSSSSSSSSSSSTTTTGGGGGGGGGGGGGGGGTTTTSSSSWWWWWWWWSWOOOOOOW
OOOOOOWWSSSTTTTTGGGGGGGGGGGGGTTTTTSSSSSSSSSSSSSSSSSSTTTTGGGGGGGGGGGGGGGTTTTTSSSSSSWWWWWWWWOOOOOOW
OOOOOOWSSSSSTTTGGGGGGGGGGGGGTTTTTSSSSSSSSSSSSSSSSSSSSTTTTTGGGGGGGGGGGGGTTTTTSSSSSWWWWWWWWWOOOOOOW
OOOOOOWWWSSSTSTTGGGGGGGGGGGGGTTTTSSSSSSSSSSSSSSSSSSSSTTTTTGGGGGGGGGGGTTTTTSSSSSSSWWWSWWWWWOOOOOOW
OOOOOOWWWSSSTTTTSGGGGGGGGGGGTTTTTSSSSSSSSSSSSSSSSSSSSTTTTGGGGGGGGGGGTTTTTTTTSSSSSSSWWWWWWWOOOOOOW
OOOOOOWWWWSSSTTTTGGGGGGGGGGGTTTSTSSSSSSSSSSSSSSSSSSSSGTTTTGGGGGGGGTTTTTTTTTSSSSSSSSSWWWWWWOOOOOOW
OOOOOOWWWWWSSTTTTSGGGGGGGGGTTTSSSSSSSSSSSSSSSSSSSSSSSTTTTTTTTTGGTTTTTTSSSSSSSSSSSSSWWWWWWWOOOOOOW
OOOOOOWWWWWSSSSTTSSSGGGGGGGTTSSSSSSSSSSSSSSSSSSSSSSSSSGTTTTTTTTTTTTTSSSSSSSSSSSSSSSSSWWWWWOOOOOOW
OOOOOOWWWWWSSSSSSSSSSGGGGGTSSSSSSSSSSSSSSSSSSSSSSSSSSSSSSTTTTTTTTTSSSSSSSSSSSSSSSSSSWWWWWWOOOOOOW
OOOOOOWWWWWWSSSSSSSSSSSGGGSSSSSSSSSSSSSSSSSSSSSSSSSSSSSSSTTTTTTTSSSSSSSSSSSSSSSSSSSSWWWWWWOOOOOOW
OOOOOOWWWWWSSSSSSSSSSSSSSSSSSSSSSSSSSSSSSSSSGSSSSSSSSSSSSSSTTTTSSSSSSSSSSSSSSSSSSSSWWWWWWWOOOOOOW
OOOOOOWWWWWSSSSSSSSSSSSSSSSSSSSSSSSSSSSSSSSSSSSSSSSSSSSSSSSSTSSSSSSSSSSSSSSSSSSSSSSWSWWWWWOOOOOOW
OOOOOOWWWWWSSSSSSSSSSSSSSSSSSSSSSSSSSSSSSSSSSSSSSSSSSSSSSSSSSSSSSSSSSSSSSSSSSSSSSSSWSSWWWWOOOOOOW
OOOOOOWWWWSSSSSSSSSSSSSSSSSSSSSSSSSSSSSSSSSSSSSSSSSSSSSSSSSSSSSSSSSSSSSSSSSSSSSSSSSSWWWWWWOOOOOOW
OOOOOOWWWSSSSSSSSSSSSSSSSSSSSSSSSSSSSSSSSSSSSSSSSSSSSSSSSSSSSSSSSSSSSSSSSSSTTGGTSSSSWWWWWWOOOOOOW
OOOOOOWWSSSSSSSSSSSSSSSSSSSSSSSSSSSSSSSSSSSSSSSSSSSSSSSSSSSSSTTTSSSSSSSSSSTTTTTTGSSSWWWWWWOOOOOOW
OOOOOOWSSSSSSSSSSSSSGGGSSSSSSSSSSSSSSSSSSSSSSSSSSSSSSSSSSSSSSSSTTTTTTTTTTTTTTTTTTSSSSWWWWWOOOOOOW
OOOOOOWWSSSSSSSSSSSGGGGGSSSSSSSSSSSSSSSSSSSSSSSSSSSSSSSSSSSSSTTTTTTTTTTTTTTTTTTTTSSSWWWWWWOOOOOOW
OOOOOOWSSSSSTTGGGGGGGGGGSTSSSSSSSSSSSSSSSSSSSSSSSSSSSSSSSSSSSTTTTTTTTTTTTTTTTTTTTSSWSWWWWWOOOOOOW
OOOOOOWSTTTTTTGGGGGGGGGGTTTSSSSSSSSSSSSSSSSSSSSSSSSSSSSSSSSSTTTTTTGGGGGGTTTTTTTTSSSWWWWWWWOOOOOOW
OOOOOOWSTTTTTGGGGGGGGGGTTTSSSSSSSSSSSSSSSSSSSSSSSSSSSSSSSSSSSTTTGGGGGGGGGGGTTTTTTSSSSWWWWWOOOOOOW
OOOOOOSSTTTTGGGGGGGGGGGTTTTSSSSSSSSSSSSSSSSSSSSSSSSSSSSSSSSSTTTTGGGGGGGGGGGTTTTTSSSSSWWWWWOOOOOOW
OOOOOOSSTTGGGGGGGGGGGGGSTTTSWWSSSSSSSSSSGGGGGGSSSSSSSSSSSSSSTTTTGGGGGGGGGGGGTTTTSSSSSWWWWWOOOOOOW
OOOOOOSSGTGGGGGGGGGGGGGGTTTSSWWSSWSSSSSGGGTTGGSSSSSSSSSSSSSSSTTGGGGGGGGGGGGGGTTSSSSSWWWWWWOOOOOOW
OOOOOOSSTTGGGGGGGGGGGGGSTTTSSWWWWWSSSSTTTTTTGGTSSSSSSSSSSSSWSTTGGGGGGGGGGGGGGGTTSSSWWWWWWWOOOOOOW
OOOOOOWSTTGGGGGGGGGGGGGGTTSSSSSSSWWSSSTTTTTTTTTTSSSSSSSSSSSSSSSSGGGGGGGGGGGGGTTSSSSWWWWWWWOOOOOOW
OOOOOOWWTTTTGGGGGGGGGGGGGGSSSSSSSSSSSTTTTTTTTTTGGSSSSSSWSSWSSSSSGGGGGGGGGGGGGGTTSSSWWWWWWWOOOOOOW
OOOOOOWWSSTTTGGGGGGGGGGGTTSSSSSSSSSSSGTTTTTTTTTTTTSTTSSSSSSSSSSSGGGGGGGGGGGGGTTSSSWWWWWWWWOOOOOOW
OOOOOOWWSSTTGGGGGGGGGGGGTTGSSSSSSSSSSTTTTTTTTTTTTTTTTTSSSSSSSSSSGGGGGGGGGGSSTTTSSSWWWWWWWWOOOOOOW
OOOOOOWWWSSTTGGGGGGGGGGTTTGSSSSSSSSSGTTTTTGGGGGTTTTTTTTSSSSSSSSSSGGGGGGGGTTTTTSSSSSWWWWWWWOOOOOOW
OOOOOOWWSTTTTTGGGGGGGGGTTTSSSSSSSSSSTTTTTTGGGGGGTTTTTTSSSSSSSSSSSSSGGGGGSSSSSSSSSSSSWWWWWWOOOOOOW
OOOOOOWWSSSSTTTGGGGGTTTTTGSSSSSSSSSTTTTTTGGGGGGGGGTTTGGGGSSSSSSSSSSSSSSSSSSSSSSSSSSSWWWWWWOOOOOOW
OOOOOOWWSSSSSTTTGGTTGTTTTSSSSSSSSSTTTTTTGGGGGGGGGGGGGGGGGGSSSSSSSSSSSSSSSSSSSSSSSSSSWWWWWWOOOOOOW
OOOOOOWWWSSSSSTTTTTTTGTTSSSSSSSSSSTTTGGGGGGGGGGGGGGGGGGGGGGSSSSSSSSSSSSSSSSSWSSSSSSSWWWWWWOOOOOOW
OOOOOOWWWWSSSSSTTTSSSSSSSSSSSSSSSSTTTGGGGGGGGGGGGGGGGGGGGGGSSSSSSSSSSSSSSWSSSSSSWSSWWWWWWWOOOOOOW
OOOOOOWWWWWSSSSTTSSSSSSSSSSSSSSSSSTTTGGGGGGGGGGGGGGGGGGGGGGSSSSSSSSSSSSSSSSSSWWWWWWWWWWWWWOOOOOOW
OOOOOOWWWWWSSSSSSSSSSSSSSSSSSSSSSSTTTGGGGGGGGGGGGGGGGGGGGGGGSSSSSSSSSSSSSSSSWWWWWWWWWWWWWWOOOOOOW
OOOOOOWWWWWSSSSSSSSSSSSSSSSSSSSSSSSTTTGGGGGGGGGGGGGGGGGGGGGGGGSSSSSSSSSSSSSWWWWWWWWWWWWWWWOOOOOOW
OOOOOOWWWWWWSSSSSSSSSSSSSSSSSSSSSSSTTTTGGGGGGGGGGGGGGGGGGGGGGGGSSSSSSSSSSSWWWWWWWWWWWWWWWWOOOOOOW
OOOOOOWWWWWSSSSSSSSSSSSSSSSSSSSSSSSSTTTTGGGGGGGGGGGGGGGGGGGGGGGSSSSSSSSSSSWWWWWWWWWWWWWWWWOOOOOOW
OOOOOOWWWWWSSSSWSSSSSSWSSSSSSSSSSSSSSTTGTTTGGGGGGGGGGGGGGGGGGGGSSSSSSSSSSSWWWWWWWWWWWWWWWWOOOOOOW
OOOOOOWWWWWSWWWWWWWSWWWSSSSSSSSSSSSSSSSTTTTTGGGGGGGGGGGGGGGGGGSSSSSSSSSWSWWWWWWWWWWWWWWWWWOOOOOOW
OOOOOOWWWWSWWWWWWWWWWWSSSSSSSSSSSSSSSSSSTTTTTGGGGGGGTTTTGGGTTSSSSSSSSSSSSSWWWWWWWWWWWWWWWWOOOOOOW
OOOOOOWWWWWWWWWWWWWWWSSSSSSSSSSSSSSSSSSTTTTTGGGGGGGTTTTTTTTTTSSSSSSSWSSSSWWWWWWWWWWWWWWWWWOOOOOOW
OOOOOOWWWWWWWWWWWWWWWWSWSSSSSSSSSSSSSSSSTTTTTGGGGGTTTTTTSTTTTSSSSSSSSSSSWWWWWWWWWWWWWWWWWWOOOOOOS
OOOOOOWWWWWWWWWWWWWWWWWWWSSSSSSSSSSSSSSSSTTTTTTTTTTTSSSSSSSSSSSSSSSSSSSSSWWWWWWWWWWWWWWWWWOOOOOOS
OOOOOOWWWWWWWWWWWWWWWWWWWSSSSSSSSSSSSSSSSTTTTTTTTTTSSSSSSSSSSSSSSSSSSSSSWWWWWWWWWWWWWWWWWWOOOOOOS
OOOOOOWWWWWWWWWWWWWWWWWWWWSSSSSSSSSSSSSSTTTTTTTTTTGSSSSSSSSSSSSSSSSSSSSWWWWWWWWWWWWWWWWWWWOOOOOOS
OOOOOOWWWWWWWWWWWWWWWWWWWWWSSSSSSSSSSSSSSTGTTGTTTTSSSSSSSSSSSSSSSSSSWSWSSWWWWWWWWWWWWWWWWWOOOOOOS
OOOOOOWWWWWWWWWWWWWWWWSWWWWWWWSSSWWSSSSSSSSSSSTTTTSSSSSSSSSSSSSSSSSSWWSSWWWWWWWWWWWWWWWWWWOOOOOOS
OOOOOOWWWWWWWWWWWWWWWWWWWWWWWWWSSWWSSSSSSSSSSSSSSSSSSSSSSSSSSSSSSSSSWWWWSWWWWWWWWWWWWWWWWWOOOOOOS
OOOOOOWWWWWWWWWWWWWWWWWWWWWWWWSSWWSSSSSSSSSSSSSSSSSSSSSSSWWSSSSSSSSWSWWSWWWWWWWWWWWWWWWWWWOOOOOOS
OOOOOOWWWWWWWWWWWWWWWWWWWWWWSWWWWWWWWSSSSSSSSSSSSSSSSSSSWWWSSSSSWWWWWWWWWWWWWWWWWWWWWWWWWWOOOOOOS
OOOOOOWWWWWWWWWWWWWWWWWWWWWWWWWWWWWWWWSSWSSSSSSSSSSSSSSSWWWWWSSWWWWWWWWWWWWWWWWWWWWWWWWWWWOOOOOOS
OOOOOOWWWWWWWWWWWWWWWWWWWWWWWWWWWWWWWWWWWWWSSSWSSSSSSSSSSWWWWWWWWWWWWWWWWWWWWWWWWWWWWWWWWWOOOOOOS
OOOOOOWWWWWWWWWWWWWWWWWWWWWWWWWWWWWWWWWWWWWSSWWWSSSSSSSSSSWWWWWWWWWWWWWWWWWWWWWWWWWWWWWWWWOOOOOOS
OOOOOOWWWWWWWWWWWWWWWWWWWWWWWWWWWWWWWWWWWWWWWWWWWWSSSSSSSWWWWWWWWWWWWWWWWWWWWWWWWWWWWWWWWWOOOOOOS
OOOOOOWWWWWWWWWWWWWWWWWWWWWWWWWWWWWWWWWWWWWWWWWWWWSSSSSSSWWWWWWWWWWWWWWWWWWWWWWWWWWWWWWWWWOOOOOOS
OOOOOOWWWWWWWWWWWWWWWWWWWWWWWWWWWWWWWWWWWWWWWWWWWWWSSSSWSWWWWWWWWWWWWWWWWWWWWWWWWWWWWWWWWWOOOOOOS
OOOOOOOOOOOOOOOOOOOOOOOOOOOOOOOOOOOOOOOOOOOOOOOOOOOOOOOOOOOOOOOOOOOOOOOOOOOOOOOOOOOOOOOOOOOOOOOOS
OOOOOOOOOOOOOOOOOOOOOOOOOOOOOOOOOOOOOOOOOOOOOOOOOOOOOOOOOOOOOOOOOOOOOOOOOOOOOOOOOOOOOOOOOOOOOOOOS
OOOOOOOOOOOOOOOOOOOOOOOOOOOOOOOOOOOOOOOOOOOOOOOOOOOOOOOOOOOOOOOOOOOOOOOOOOOOOOOOOOOOOOOOOOOOOOOOS
OOOOOOOOOOOOOOOOOOOOOOOOOOOOOOOOOOOOOOOOOOOOOOOOOOOOOOOOOOOOOOOOOOOOOOOOOOOOOOOOOOOOOOOOOOOOOOOOS
