type octile-corner
height 97
width 97
map
0000000000000000000000000000000000000000000000000000000000000000000000000000000000000000000000000
0000000000000000000000000000000000000000000000000000000000000000000000000000000000000000000000000
0000000000000000000000000000000000000000000000000000000000000000000000000000000000000000000000000
0000000000000000000000000000000000000000000000000000000000000000000000000000000000000000000000000
0000000000000000000000000000000000000000000000000000000000000000000000000000000000000000000000000
0000000000000000000000000000000000000000000000000000000000000000000000000000000000000000000000000
0000000000000000000000000000000000000000000000000000000000000000000000000000000000000000000000000
0000000000000000000000000000000000000000000000000000000000000000000000000000000000000000000000000
0000000000000000000000000000000000000000000000000000000000000000000000000000000000000000000000000
0000000000000000000000000000000000000000000000000000000000000000000000000000000000000000000000000
0000000000000000000000000000000000000000000000000000000000000000000000000000000000000000000000000
0000000000000000000000000000000000000000000000000000000000000000000000000000000000000000000000000
0000000000000000000000000000000000000000000000000000000000000000000000000000000000000000000000000
0000000000000000000010100000000000000000000000000000000000000000000000000000000000000000000000000
0000000000000000000121100000000000000000000000000000000000000000000000000000000000000000000000000
0000000000000000011122100000001100100000000000000000000000000000000000000000000000000000000000000
0000000000000000111222000000000100111002000000000022000000000000000000000000000000000000000000000
0000000000000000100211010000000111011222220000000222200000000000000000000000000000000000000000000
0000000000000000000011120000000111012222220000012222222200000000000000022010000000000000000000000
0000000000000000000000120000000001222222222220012222222220001100100002222210000000000000000000000
0000000000000000000000000000000002222222222222222222222222001001102222222200100000000000000000000
0000000000000000010000000100000122222222222222222222222220011211222222222220100000000000000000000
0000000000000000111200002100000122222222222222222222222222002201222222222221100000000000000000000
0000000000000001222222012210000022222222222222222222222222002201222222222222000000000000000000000
0000000000000011222222211100000222222222222222222222222220001012222222222222222000000000000000000
0000000000000022222222220000000222222222222222222222222220000002222222222222222000000000000000000
0000000000000022222222222200000022222222222222222222222222000002222222222222222200000000000000000
0000000000000022222222222220000222222222222222222222222222000022222222222222222200000000000000000
0000000000002222222222222222000012222222222222222222222222002222222222222222222000000000000000000
0000000000002222222222222222000012222222222222222222222222222222222222222222222000000000000000000
0000000000222222222222222222200000022222222222222222222222222222222222222222222000000000000000000
0000000000022222222222222222200000012222222222222222222222222222222222222222220000000000000000000
0000000000002222222222222222220000112222222222222222222222222222222222222222200000000000000000000
0000000000022222222222222222220000002222222222222222222222222222222222222222220000000000000000000
0000000000022222222222222222210000022222222222222222222222222222222222222222222000000000000000000
0000000000002222222222222222200000222222222222222222222222222222222222222222222200000000000000000
0000000000002222222222222222000000222222222222222222222222222222222222222222222220000000000000000
0000000000000022222222222222000000222222222222222222222222222222222222222222222220000000000000000
0000000000000012022222222222000002222222222222222222222222222222222222222222222222000000000000000
0000000000000011001222222210000022222222222222222222222222222222222222222222222220000000000000000
0000000000000001001102220010000022222222222222222222222222222222222222222222222210000000000000000
0000000000000000000000000000000222222222222222222222222222222222222222222222222110000000000000000
0000000000002000000000000000000222222222222222222222222222222222222222222222222000000000000000000
0000000000002210000000000000000222222222222222222222222222222222222222222222200000000000000000000
0000000000000210000000000001022222222222222222222222222222222222222222222222220000000000000000000
0000000000001211100000000011222222222222222222222222222222222222222222222222222000000000000000000
0000000000000100200000000011222222222222222222222222222222222222222222222222222100000000000000000
0000000000000000000000220022222222222222222222222222222222222222222222222222221000000000000000000
0000000000000000010222222222222222222222222222222222222222222222222222222022001000000000000000000
0000000000000000122222222222222222222222222222222222222222222222222222222000000000000000000000000
0000000000000000122222222222222222222222222222222222222222222222222222200000000000000000000000000
0000000000000000222222222222222222222222222222222222222222222222222222200000000000000000000000000
0000000000000000222222222222222222222222222222222222222222222222222222000002202200000000000000000
0000000000000000222222222222222222222222222222222222222222222222222222000022222200000000000000000
0000000000000000222222222222222222222222222222222222222222222222222220000222222100100000000000000
0000000000000110222222222222222222222222222222222222222222222222222220000222222112200000000000000
0000000000000011021222222222222222222222222222222222222222222222222000000222222202100000000000000
0000000000000121011112122222222222222222222222222222222222222222200000002222222212100000000000000
0000000000000101000111111111111122222222222222222222222222222222200000002222222211000000000000000
0000000000000000000011111111111122222222222222222222222222222221000000222222222221000000000000000
0000000000000000001111111111111122222222222222222222222222222000000222222222222220000000000000000
0000000000000000011111111111111122222222222222222222222222222200002222222222222222000000000000000
0000000000000000011111111111111111111111122222222222222222222200002222222222222222000000000000000
0000000000000000111111111111111111111111122222222222222222222000000222222222222222000000000000000
0000000000000000111111111111111111111111122222222222222222222211000222222222222222000000000000000
0000000000000000000111111111111111111111122222222222222222222210000002222222222220000000000000000
0000000000000000000111111111111111111111122222222222222222222222000000222222222220000000000000000
0000000000000000000111111111111111111111122222222222222222222222200000222222222220000000000000000
0000000000000000001111111111111111111111122222222222222222222222222000022222222200000000000000000
0000000000000000011111111111111111111111111122222222222222222222222200011222222200000000000000000
0000000000000000011111111111111111111111111122222222222222222222222220000222221100000000000000000
0000000000000000011111111111111111111111111122222222222222222222222220000020001000000000000000000
0000000000000000001111111111111111111111111122222222222222222222222222000000000101000000000000000
0000000000000000001111111111111111111111111122222222222222222222222222000000011122000000000000000
0000000000000000001111111111111111111111111122222222222222222222222222200000010122100000000000000
0000000000000000000111111111111111111111011002002222222222222222222222210000000012100000000000000
0000000000000000100111111111111111111111000000002222222222222222222222100000000000000000000000000
0000000000000011110101111110111111111100000000022222222212222222222221210000000000000000000000000
0000000000000000110000011000011111110000000100022222221010222222222220220000000000000000000000000
0000000000000000000000001000000110000000022100000022201000100220002200100000102000000000000000000
0000000000000002210100010000000000000001122200000022000001000000000000000012222100000000000000000
0000000000000002210210010000000000000000110210000000000011100000000000000222233100000000000000000
0000000000000000010100000000000000000000000111000000000021100000000000001221221100000000000000000
0000000000000000000000000000000000000000000001000000000000000000000000000010220000000000000000000
0000000000000000000000000000000000000000000000000000000000000000000000000000000000000000000000000
0000000000000000000000000000000000000000000000000000000000000000000000000000000000000000000000000
0000000000000000000000000000000000000000000000000000000000000000000000000000000000000000000000000
0000000000000000000000000000000000000000000000000000000000000000000000000000000000000000000000000
0000000000000000000000000000000000000000000000000000000000000000000000000000000000000000000000000
0000000000000000000000000000000000000000000000000000000000000000000000000000000000000000000000000
0000000000000000000000000000000000000000000000000000000000000000000000000000000000000000000000000
0000000000000000000000000000000000000000000000000000000000000000000000000000000000000000000000000
0000000000000000000000000000000000000000000000000000000000000000000000000000000000000000000000000
0000000000000000000000000000000000000000000000000000000000000000000000000000000000000000000000000
0000000000000000000000000000000000000000000000000000000000000000000000000000000000000000000000000
0000000000000000000000000000000000000000000000000000000000000000000000000000000000000000000000000
0000000000000000000000000000000000000000000000000000000000000000000000000000000000000000000000000
WWWWWWWWWWWWWWWWWWWWWWWWWWWWWWWWWWWWWWWWWWWWWWWWWWWWWWWWWWWWWWWWWWWWWWWWWWWWWWWWWWWWWWWWWWWWWWWWW
OOOOOOOOOOOOOOOOOOOOOOOOOOOOOOOOOOOOOOOOOOOOOOOOOOOOOOOOOOOOOOOOOOOOOOOOOOOOOOOOOOOOOOOOOOOOOOOOW
OOOOOOOOOOOOOOOOOOOOOOOOOOOOOOOOOOOOOOOOOOOOOOOOOOOOOOOOOOOOOOOOOOOOOOOOOOOOOOOOOOOOOOOOOOOOOOOOW
OOOOOOOOOOOOOOOOOOOOOOOOOOOOOOOOOOOOOOOOOOOOOOOOOOOOOOOOOOOOOOOOOOOOOOOOOOOOOOOOOOOOOOOOOOOOOOOOW
OOOOOOOOOOOOOOOOOOOOOOOOOOOOOOOOOOOOOOOOOOOOOOOOOOOOOOOOOOOOOOOOOOOOOOOOOOOOOOOOOOOOOOOOOOOOOOOOW
OOOOOOOOOOOOOOOOOOOOOOOOOOOOOOOOOOOOOOOOOOOOOOOOOOOOOOOOOOOOOOOOOOOOOOOOOOOOOOOOOOOOOOOOOOOOOOOOW
OOOOOOOOOOOOOOOOOOOOOOOOOOOOOOOOOOOOOOOOOOOOOOOOOOOOOOOOOOOOOOOOOOOOOOOOOOOOOOOOOOOOOOOOOOOOOOOOW
OOOOOOOOOOOOOOOOOOOOOOOOOOOOOOOOOOOOOOOOOOOOOOOOOOOOOOOOOOOOOOOOOOOOOOOOOOOOOOOOOOOOOOOOOOOOOOOOW
OOOOOOOOOOOOOOOOOOOOOOOOOOOOOOOOOOOOOOOOOOOOOOOOOOOOOOOOOOOOOOOOOOOOOOOOOOOOOOOOOOOOOOOOOOOOOOOOW
OOOOOOOOOOOOOOOOOOOOOOOOOOOOOOOOOOOOOOOOOOOOOOOOOOOOOOOOOOOOOOOOOOOOOOOOOOOOOOOOOOOOOOOOOOOOOOOOW
OOOOOOOOOOOOOOOOOOOOOOOOOOOOOOOOOOOOOOOOOOOOOOOOOOOOOOOOOOOOOOOOOOOOOOOOOOOOOOOOOOOOOOOOOOOOOOOOW
OOOOOOOOOOOOOOOOOOOOOOOOOOOOOOOOOOOOOOOOOOOOOOOOOOOOOOOOOOOOOOOOOOOOOOOOOOOOOOOOOOOOOOOOOOOOOOOOW
OOOOOOOOOOOOOOOOOOOOOOOOOOOOOOOOOOOOOOOOOOOOOOOOOOOOOOOOOOOOOOOOOOOOOOOOOOOOOOOOOOOOOOOOOOOOOOOOW
OOOOOOOOOOOOOOOOOOOOOOOOOOOOOOOOOOOOOOOOOOOOOOOOOOOOOOOOOOOOOOOOOOOOOOOOOOOOOOOOOOOOOOOOOOOOOOOOW
OOOOOOOOOOOOOOOOOOOOOOOOOOOOOOOOOOOOOOOOOOOOOOOOOOOOOOOOOOOOOOOOOOOOOOOOOOOOOOOOOOOOOOOOOOOOOOOOW
OOOOOOOOOOOOOOOOOOOOOOOOOOOOOOOOOOOOOOOOOOOOOOOOOOOOOOOOOOOOOOOOOOOOOOOOOOOOOOOOOOOOOOOOOOOOOOOOW
OOOOOOOOOOOOOOOOOOOOOOOOOOOOOOOOOOOOOOOOOOOOOOOOOOOOOOOOOOOOOOOOOOOOOOOOOOOOOOOOOOOOOOOOOOOOOOOOW
OOOOOOOOOOOOOOOOOOOOOOOOOOOOOOOOOOOOOOOOOOOOOOOOOOOOOOOOOOOOOOOOOOOOOOOOOOOOOOOOOOOOOOOOOOOOOOOOW
OOOOOOOOOOOOOOOOWWWWSSSGWWWWWWWSSSWSGTTTTGWWWWWSGTTTGGGGWWWWWWWWWWWWWWWGGWSWWWWWOOOOOOOOOOOOOOOOW
OOOOOOOOOOOOOOOOWWWWWWSGWWWWWWWWWSGGGTTTTGGGGWWSTTTTTTTGGWWWSSWWSWWWWGGTGGSWWWWWOOOOOOOOOOOOOOOOW
OOOOOOOOOOOOOOOOWWWWWWWWWWWWWWWWWGGGGGTTTTTTGGGGTTTTTTTTGGWWSWWSSWGGGTTTTGWWSWWWOOOOOOOOOOOOOOOOW
OOOOOOOOOOOOOOOOWSWWWWWWWSWWWWWSGTTGGGGGTTTTTGGTTTTTTTTTGWWSSGSSGGTTTTTTTGGWSWWWOOOOOOOOOOOOOOOOW
OOOOOOOOOOOOOOOOSSSGWWWWGSWWWWWSTTGTGGGGGTTGTGGGGTTTTTTTGGWWGGWSTTTTTTTTTGGSSWWWOOOOOOOOOOOOOOOOW
OOOOOOOOOOOOOOOOGGGGGGWSGGSWWWWWTTTTGGGGGGGGGGGGGGGTTTTTTGWWTGWSTTTTTTTGGGGGWWWWOOOOOOOOOOOOOOOOW
OOOOOOOOOOOOOOOOTGGGGGGSSSWWWWWGTTTGGGGGGGGGGGGGGGGGTTGTGWWWSWSGTTTTTGGGGGGGGGGWOOOOOOOOOOOOOOOOW
OOOOOOOOOOOOOOOOTTGGGGGGWWWWWWWTTTTTGGGGGGGGGGGGGGGGTTTTGWWWWWWTTTTTGGGGGGTTTTGWOOOOOOOOOOOOOOOOW
OOOOOOOOOOOOOOOOTTGGGGTGGGWWWWWWTTTTTGGGGGGGGGGGGGGGTTTTGGWWWWWTTTTGGGGGGGTTTTGGOOOOOOOOOOOOOOOOW
OOOOOOOOOOOOOOOOTTGGGGTTTGGWWWWGTTTTTGGGGGGGGGGGGGGTTTTTTGWWWWGTTTGGGGGGGGTTTTTGOOOOOOOOOOOOOOOOW
OOOOOOOOOOOOOOOOTTGGGGGTTTGGWWWWSTTTTTGGGGGGGGGGGGTTTTTTGGWWGGGGGGGGGGGGGGGTTTGWOOOOOOOOOOOOOOOOW
OOOOOOOOOOOOOOOOTTGGGGGGTGGGWWWWSTTTTTTGGGGGGGGGGGTTTTTTTGGGGGGGGGGGGGGGGGGTTTGWOOOOOOOOOOOOOOOOW
OOOOOOOOOOOOOOOOTTGGGGGGGGGGGWWWWWWTTTTTGGGGGGGGGGGTTTTTGTGGGGGGGGGGGGGGGGTTTTGWOOOOOOOOOOOOOOOOW
OOOOOOOOOOOOOOOOTTGGGGGGGGGTGWWWWWWSTTTTTGGGGGGGGGGGTTTTTTTGGGGGGGGGGGGGGGTTTGWWOOOOOOOOOOOOOOOOW
OOOOOOOOOOOOOOOOTTTGGGGGGGGTGGWWWWSSTTTTTTGGGGGGGGGGGTTTTTGGGGGGGGGGGGGGGGTTGWWWOOOOOOOOOOOOOOOOW
OOOOOOOOOOOOOOOOTTTGGGGGGGGTTGWWWWWWTTTTTTGGGGGGGGGGGGTTTGGGGGGGGGGGGGGGGGGTGGWWOOOOOOOOOOOOOOOOW
OOOOOOOOOOOOOOOOTTTGGGGGGGTTGSWWWWWGTTTTTGGGGGGGGGGGGGGGGGGGGGGGTTTGGGGGGGGGGGGWOOOOOOOOOOOOOOOOW
OOOOOOOOOOOOOOOOTGTGGGGGGGTTGWWWWWGTTTTTGGGGGGGGGGGGGGGGGGGGGGGGTTTTGGGGGGGGGGGGOOOOOOOOOOOOOOOOW
OOOOOOOOOOOOOOOOTTTTGGGGGTTGWWWWWWGGTGTGGGGGGGGGGGGGGGGGGGGGGGGTTTTTTGGGGGGGGGGGOOOOOOOOOOOOOOOOW
OOOOOOOOOOOOOOOOTTTTGGGGGTTGWWWWWWGGGGGGGGGGGGGGGGGGGGGGGGGGGGGGGTTTTGGGGGGGGTTTOOOOOOOOOOOOOOOOW
OOOOOOOOOOOOOOOOWTTTGGGGTTTGWWWWWGGGGGGGGGGGGGGGGGGGGGGGGGGGGGGGGTTTTGGGGGGGTTTTOOOOOOOOOOOOOOOOW
OOOOOOOOOOOOOOOOWWSTGGGGTGSWWWWWGTTGGGGGGGGGGGGGGGGGGGGGGGGGGGGGGGTTTGGGGGGGTTTTOOOOOOOOOOOOOOOOW
OOOOOOOOOOOOOOOOWWSSWGGGWWSWWWWWTTTTGGGGGGGGGGGGGGGGGGGGTGGGGGGGGGGTGGGGGGGTTTTGOOOOOOOOOOOOOOOOW
OOOOOOOOOOOOOOOOWWWWWWWWWWWWWWWGTTTGGGGGGGGGGGGGGGGGGGGGTTTGGGGGGGGGGGGGGGGTTTGSOOOOOOOOOOOOOOOOW
OOOOOOOOOOOOOOOOWWWWWWWWWWWWWWWTTTTGGGGGGGGGGGGGGGGGGGGGTTTTTTTGGGGGGGGGGGGTTTGWOOOOOOOOOOOOOOOOW
OOOOOOOOOOOOOOOOWWWWWWWWWWWWWWWTTTTGGGGGGGGGTGGGGGGGGGGTTTTTTTTGGGGGGGGGGGGGGWWWOOOOOOOOOOOOOOOOW
OOOOOOOOOOOOOOOOWWWWWWWWWWWSWGGTTTGGGGGGGGTTTTGGGGGGTTTTTTTTTTTTGGGGGGGGGGGGGGWWOOOOOOOOOOOOOOOOW
OOOOOOOOOOOOOOOOSWWWWWWWWWSSGTTTTTGGGGGGGGTGTTTGGGGTTTTTTTTTTTTTTGGGGGGGGGGGTGGWOOOOOOOOOOOOOOOOW
OOOOOOOOOOOOOOOOGWWWWWWWWWSSTTTTTGTGGGGGGGTTGTTTGGGGTTTTTTTTTTTTTTTTGGGGGGGGTTGSOOOOOOOOOOOOOOOOW
OOOOOOOOOOOOOOOOWWWWWWGGWWGGTTTTTTGGGGGGGTTTTTTGGGGGGGTTTTTTTTTTTTTTTTGGGGTTTGSWOOOOOOOOOOOOOOOOW
OOOOOOOOOOOOOOOOWSWGGGGGGGTTTTTTTTGGGGGGTTTTTTTGGGGGGGTTTTTTTTTTTTTTTTTTGWTGWWSWOOOOOOOOOOOOOOOOW
OOOOOOOOOOOOOOOOSGGTTGGGGTTTTTTTTTTTGGTTTTTTTGGGGGGGGTTTTTTTTTTTTTTTTTTTGWWWWWWWOOOOOOOOOOOOOOOOW
OOOOOOOOOOOOOOOOSTTTTGGGGTTTTTTTTTTTTTTTTTTTGTGGGGGGGTTTTTGGTTTTTTTTTTGWWWWWWWWWOOOOOOOOOOOOOOOOW
OOOOOOOOOOOOOOOOGTGGGGGGGGTTTTTTTTTTTTTTTTTTTTGGGGGGTTTTTGGGGTTTTTTTTTGWWWWWWWWWOOOOOOOOOOOOOOOOW
OOOOOOOOOOOOOOOOTTTGGGGGGGGGTTTTTTTTTTTTTTTTTTGGGGGGTTTTGGGGGGGGTTTTTGWWWWWGGWGGOOOOOOOOOOOOOOOOW
OOOOOOOOOOOOOOOOTTTGGGGGGGGGGGTTTTTTTTTTTTTTTTTGGGGGTTTTGGGGGGGGTTTTTGWWWWGTGGTGOOOOOOOOOOOOOOOOW
OOOOOOOOOOOOOOOOTTTTGGGGGGGGGGTTTTTTTTTTTTTTTTTGGGGGTTTGGGGGGGGTTTTTGWWWWGGTTTGSOOOOOOOOOOOOOOOOW
OOOOOOOOOOOOOOOOTTTTTTGGGGGGGGGTTTTTTTTTTTTTTTGTGGGGGTGGGGGGGGGTTTTTGWWWWGGTTTGSOOOOOOOOOOOOOOOOW
OOOOOOOOOOOOOOOOWGSTTTTGGGGGGGGGGTTGTTTTTTTGGGTGGGGGGGGGGGGGGGTTTTGWWWWWWGGGTGGGOOOOOOOOOOOOOOOOW
OOOOOOOOOOOOOOOOWSSSSGSggggggggggGGGGGTTTTGGGGGGGGGGGGGGGGGGGGTTGWWWWWWWGGGGGGGGOOOOOOOOOOOOOOOOW
OOOOOOOOOOOOOOOOWWWSSSSgggssssssgGGGGGTTTGGGGGGGGGGGGGGGGGGGGTTGGWWWWWWWGGGGGGGGOOOOOOOOOOOOOOOOW
OOOOOOOOOOOOOOOOWWWWSSSsssssssgsgGGGGGGTTGGGGGGGGGGGGGGGGGGGGGGSWWWWWWGGGGGGGGTGOOOOOOOOOOOOOOOOW
OOOOOOOOOOOOOOOOWWSSSSSSSSSSSSttgGGGGGGGGGGGGGGGGGGGGGGGGGTGGSWWWWWGGGGGGGGGGGTTOOOOOOOOOOOOOOOOW
OOOOOOOOOOOOOOOOWSGGSSSSSSSSSStttgggggggggGGGGGGGGGGGGGGTTTTGGWWWWGTTTGGGGGGGTTTOOOOOOOOOOOOOOOOW
OOOOOOOOOOOOOOOOWTTGGSSSSSSSSSstttgggssssgGGGGGGGGGGGGGGGTTTTGWWWWTTTTGGGGGGGTTTOOOOOOOOOOOOOOOOW
OOOOOOOOOOOOOOOOSTTTTGGGSGGGSSsstttssssssgGGGGGGGGGGGGGGTTTTGWWWWWWTTTTGGGGGGTTTOOOOOOOOOOOOOOOOW
OOOOOOOOOOOOOOOOTTTTTGGGGGGGGGSSSSSSSSSssgGGGGGGGGGGGGGGTTTTGGSSWWWTTTGGGGGGGGTTOOOOOOOOOOOOOOOOW
OOOOOOOOOOOOOOOOWWWTTTTGGGGGGGGSSSSSSSSssgGGGGGGGGGGGGGGGTTTTGSWWWWWSTTGGGGGGGGTOOOOOOOOOOOOOOOOW
OOOOOOOOOOOOOOOOWWWTTTTGGGGGGGGGSSSSSSSsggGGGGGGGGGGGGGGGGTGGGGGWWWWWSTGGGGGGGGGOOOOOOOOOOOOOOOOW
OOOOOOOOOOOOOOOOWWWTTTGGGGGGGGGGGSSSSSSssgGGGGGGGGGGGGGGGGGGGTTGGWWWWWTGGGGGGGTTOOOOOOOOOOOOOOOOW
OOOOOOOOOOOOOOOOWWSTTTGGGGGGGGGGGGGGGSSsgggggGTTTTGGGGGGGGGGGTTTGGGWWWWGGGGGGGTGOOOOOOOOOOOOOOOOW
OOOOOOOOOOOOOOOOWSTTTGGGGGGGGGGGGGGGGGSsgsgggTTTTTGGGGGGGGGGGTTTTTGGWWWSSTGGGGGGOOOOOOOOOOOOOOOOW
OOOOOOOOOOOOOOOOWTTTTTGGGGGGGGGGGGGGGGSsssgttTTTTGGGGGGGGGGGGGGTTTTGGWWWWGTGGGSSOOOOOOOOOOOOOOOOW
OOOOOOOOOOOOOOOOWTTTTGGGGGGGGGGGGGGGGGSSSStttTTTTTGGGGGGGGGGGGGTTTTTGWWWWWGWWWSWOOOOOOOOOOOOOOOOW
OOOOOOOOOOOOOOOOWWTTTGGGGGGGGGGGGGGGGGSSSSsttTTTTTGGGGGGGGGGGGGGTTTTGGWWWWWWWWWSOOOOOOOOOOOOOOOOW
OOOOOOOOOOOOOOOOWWTTTGGGGGGGGGGGGGGGGGSSSSsttTTTTTTGGGGGGGGGGGGGTTTTTGWWWWWWWSSSOOOOOOOOOOOOOOOOW
OOOOOOOOOOOOOOOOWWTTTGGGGGGGGGGGGGGGGGSSSSSSTTTTTTTGGGGGGGGGGGGGGTTTTGGWWWWWWSWSOOOOOOOOOOOOOOOOW
OOOOOOOOOOOOOOOOWWSTTGGGGGGGTGGGGTGGGGSSWSSWWGWWTTTTTGGGGGGGGGGGGTTTTTGSWWWWWWWWOOOOOOOOOOOOOOOOW
OOOOOOOOOOOOOOOOSWWGGGGGGGTTTTGTTTGGGSSSWWWWWWWWTTTTTGGGGGTTGGGGGTTTTGSWWWWWWWWWOOOOOOOOOOOOOOOOW
OOOOOOOOOOOOOOOOSSWGSGGGGTGSTTTTTTTTGSWWWWWWWWWGTTTTTTTGSTTTTGGGGTTTGSGSWWWWWWWWOOOOOOOOOOOOOOOOW
OOOOOOOOOOOOOOOOSSWWWSSGGSSWSTTTTTTGSWWWWWWSWWWTTTTTTGSWSWTTTTGGGGTTGWGGWWWWWWWWOOOOOOOOOOOOOOOOW
OOOOOOOOOOOOOOOOWWWWWWWSGSWWWWSTGWWWWWWWWGGSWWWWWWTTGWSWWWSWWGGWWWTGWWSWWWWWSWGWOOOOOOOOOOOOOOOOW
OOOOOOOOOOOOOOOOGSWSWWWSWWWWWWWSSWWWWWWSSTGGWWWWWWTGWWWWWSWWWWWWWWWWWWWWWWSGGGGSOOOOOOOOOOOOOOOOW
OOOOOOOOOOOOOOOOGSWGSWWSWWWWWWWWWWWWWWWWSSWGSWWWWWWWWWWWSSSWWWWWWWWWWWWWWGGTGTGSOOOOOOOOOOOOOOOOW
OOOOOOOOOOOOOOOOOOOOOOOOOOOOOOOOOOOOOOOOOOOOOOOOOOOOOOOOOOOOOOOOOOOOOOOOOOOOOOOOOOOOOOOOOOOOOOOOW
OOOOOOOOOOOOOOOOOOOOOOOOOOOOOOOOOOOOOOOOOOOOOOOOOOOOOOOOOOOOOOOOOOOOOOOOOOOOOOOOOOOOOOOOOOOOOOOOW
OOOOOOOOOOOOOOOOOOOOOOOOOOOOOOOOOOOOOOOOOOOOOOOOOOOOOOOOOOOOOOOOOOOOOOOOOOOOOOOOOOOOOOOOOOOOOOOOW
OOOOOOOOOOOOOOOOOOOOOOOOOOOOOOOOOOOOOOOOOOOOOOOOOOOOOOOOOOOOOOOOOOOOOOOOOOOOOOOOOOOOOOOOOOOOOOOOW
OOOOOOOOOOOOOOOOOOOOOOOOOOOOOOOOOOOOOOOOOOOOOOOOOOOOOOOOOOOOOOOOOOOOOOOOOOOOOOOOOOOOOOOOOOOOOOOOW
OOOOOOOOOOOOOOOOOOOOOOOOOOOOOOOOOOOOOOOOOOOOOOOOOOOOOOOOOOOOOOOOOOOOOOOOOOOOOOOOOOOOOOOOOOOOOOOOW
OOOOOOOOOOOOOOOOOOOOOOOOOOOOOOOOOOOOOOOOOOOOOOOOOOOOOOOOOOOOOOOOOOOOOOOOOOOOOOOOOOOOOOOOOOOOOOOOW
OOOOOOOOOOOOOOOOOOOOOOOOOOOOOOOOOOOOOOOOOOOOOOOOOOOOOOOOOOOOOOOOOOOOOOOOOOOOOOOOOOOOOOOOOOOOOOOOW
OOOOOOOOOOOOOOOOOOOOOOOOOOOOOOOOOOOOOOOOOOOOOOOOOOOOOOOOOOOOOOOOOOOOOOOOOOOOOOOOOOOOOOOOOOOOOOOOW
OOOOOOOOOOOOOOOOOOOOOOOOOOOOOOOOOOOOOOOOOOOOOOOOOOOOOOOOOOOOOOOOOOOOOOOOOOOOOOOOOOOOOOOOOOOOOOOOW
OOOOOOOOOOOOOOOOOOOOOOOOOOOOOOOOOOOOOOOOOOOOOOOOOOOOOOOOOOOOOOOOOOOOOOOOOOOOOOOOOOOOOOOOOOOOOOOOW
OOOOOOOOOOOOOOOOOOOOOOOOOOOOOOOOOOOOOOOOOOOOOOOOOOOOOOOOOOOOOOOOOOOOOOOOOOOOOOOOOOOOOOOOOOOOOOOOW
OOOOOOOOOOOOOOOOOOOOOOOOOOOOOOOOOOOOOOOOOOOOOOOOOOOOOOOOOOOOOOOOOOOOOOOOOOOOOOOOOOOOOOOOOOOOOOOOW
OOOOOOOOOOOOOOOOOOOOOOOOOOOOOOOOOOOOOOOOOOOOOOOOOOOOOOOOOOOOOOOOOOOOOOOOOOOOOOOOOOOOOOOOOOOOOOOOW
OOOOOOOOOOOOOOOOOOOOOOOOOOOOOOOOOOOOOOOOOOOOOOOOOOOOOOOOOOOOOOOOOOOOOOOOOOOOOOOOOOOOOOOOOOOOOOOOW
