type octile
height 70
width 64
map
@@@@@@@@@@@@@@@@@@@@@@@@@@@@@@@@@@@@@@@@@@@@@@@@@@@@@@@@@@@@@@@@
@@@@@@@@@@@@@@@@@@@@@@@@@@@@@@@@@@@@@@@@@@@@@@@@@@@@@@@@@@@@@@@@
@@@@@@@@@@@@@@@@@@@@@@@@@@@@@@@@@@@@@@@@@@@@@@@@@@@@@@@@@@@@@@@@
@@@@@@@@@@@@@@@@@@@@@@@@@@@@@@@@@@@@@@@@@@@@@@@@@@@@@@@@@@@@@@@@
@@@@@@@@@@@@@@@@@@@@@@@@@@@@@@@@@@@@@@@@@@@@@@@@@@@@@@@@@@@@@@@@
@@@@@@@@@@@@@@@@@@@@@@@@@@@@@@@@@@@@@@@@@@@@@@@@@@@@@@@@@@@@@@@@
@@@@@@@@@@@@@@@@@@@@@@@@@@@@@@@@@@@@@@@@@@@@@@@@@@@@@@@@@@@@@@@@
@@@@@@@@@@@@@@@@@@@@@@@@@@@@@@@@@@@@@@@@@@@@@@@@@@@@@@@@@@@@@@@@
@@@@@@@@@@@@@@@@@@@@@@@@@@@@@@@@@@@@@@@@@@@@@@@@@@@@@@@@@@@@@@@@
@@@@@@@@@@@@@@@@@@@@@@@@@@@@@@@@@@@@@@@@@@@@@@@@@@@@@@@@@@@@@@@@
@@@@@@@@@@@@@@@@@@@@@@@@@@@@@@@@@@@@@@@@@@@@@@@@@@@@@@@@@@@@@@@@
@@@@@@@@@@@@@@@@@@@@@@@@@@@@@@@@@@@@@@@@@@@@@@@@@@@@@@@@@@@@@@@@
@@@@@@@@@@@@@@@@@@@@@@@@@@@@@@@@@@@...@@@@@@@@@@@@@@@@@@@@@@@@@@
@@@@@@@@@@@@@@@@@@@@@@@@@@@@@@@@@@.....@@@@@@@@@@@@@@@@@@@@@@@@@
@@@@@@@@@@@@@@@@@@@@@@@@@@@@@@@@@...@@..@@@@@@@@@@@@@@@@@@@@@@@@
@@@@@@@@@@@@@@@@@@@@@@@@@@@@@@@@@...@@...@@@@@@@@@@@@@@@@@@@@@@@
@@@@@@@@@@@@@@@@@@@@@@@@@@@@@@@@@@..@.....@@@@@@@@@@@@@@@@@@@@@@
@@@@@@@@@@@@@@@@@@@@@@@@@@@@@@@@@@@........@@@@@@@@@@@@@@@@@@@@@
@@@@@@@@@@@@@@@@@@@@@@@@@@@@@@@@@@@@........@@@@@@@@@@@@@@@@@@@@
@@@@@@@@@@@@@@@@@@@@@@@@@@@@@@@@@@@@@........@@@@@@@@@@@@@@@@@@@
@@@@@@@@@@@@@@@@@@@@@@@@@@@@@@@@@@@@@.........@@@@@@@@@@@@@@@@@@
@@@@@@@@@@@@@@@@@@@@@@@@@@@..@@@@@@............@@@@@@@@@@@@@@@@@
@@@@@@@@@@@@@@@@@@@@@@@@@@@..@@@@@..............@@@@@@@@@@@@@@@@
@@@@@@@@@@@@@@@@@@@@@@@@@@@@.....................@@@@@@@@@@@@@@@
@@@@@@@@@@@@@@@@@@@@@@@@@@@@@..............@@.....@@@@@@@@@@@@@@
@@@@@@@@@@@@@@@@@@@@@@@@@@@@@@............@@@@.....@@@@@@@@@@@@@
@@@@@@@@@@@@@@@@@@@@@@@@@@@@@@.............@@@......@@@@@@@@@@@@
@@@@@@@@@@@@@@@@@@@@@@@@@@@@@..............@..........@@@@@@@@@@
@@@@@@@@@@@@@@@@@@@@@@@@@@@@...........................@@@@@@@@@
@@@@@@@@@@@@@@@@@@@@@@@@@@@............................@@@@@@@@@
@@@@@@@@@@@@@@@@@@@@@@@................................@@@@@@@@@
@@@@@@@@@@@@@@@@@@@@@@@@..................................@@@@@@
@@@@@@@@@@@@@@@@@@@@@@@@..........................@........@@@@@
@@@@@@@@@@@@@@..@@@@@@@..........................@@@........@@@@
@@@@@@@@@@@@....@@@@@@...........@@.............@@@@@........@@@
@@@@@@@@@@@.....@@@@.............@@............@@@@@@@......@@@@
@@@@@@@@@@....................................@@@@@@@@@....@@@@@
@@@@@@@@@......................................@@@@@@@@@..@@@@@@
@@@@@@@@.........................................@@@@@@@@@@@@@@@
@@@@@@@.......@..................................@@@@@@@@@@@@@@@
@@@@@@@@....@@@@...........................@@.....@@@@@@@@@@@@@@
@@@@@@@@....@@@@..........................@@@@.....@@@@@@@@@@@@@
@@@@..@@...@@@@@@........................@@@@@@.....@@@@@@@@@@@@
@@@........@@@@@@.......................@@@@@@@@....@@@@@@@@@@@@
@@...........@@@@......................@@@@@@@@@@..@@@@@@@@@@@@@
@@.............@@.......................@@@@@@@@@@@@@@@@@@@@@@@@
@@@.......................................@@@@@@@@@@@@@@@@@@@@@@
@@@@.................@@...........@@......@@@@@@@@@@@@@@@@@@@@@@
@@@@@...............@@@..........@@@@......@@@@@@@@@@@@@@@@@@@@@
@@@@@@...............@@.........@@@@@@......@@@@@@@@@@@@@@@@@@@@
@@@@@@@........................@@@@@@@@......@@@@@@@@@@@@@@@@@@@
@@@@@@@@.......................@@@@@@@@@....@@@@@@@@@@@@@@@@@@@@
@@@@@@@@@...............@......@@@@@@@@@@..@@@@@@@@@@@@@@@@@@@@@
@@@@@@@@@@.............@@@.......@@@@@@@@.@@@@@@@@@@@@@@@@@@@@@@
@@@@@@@@@@@...........@@@@@......@@@@@@@@@@@@@@@@@@@@@@@@@@@@@@@
@@@@@@@@@@@@.........@@@@@@@.....@@@@@@@@@@@@@@@@@@@@@@@@@@@@@@@
@@@@@@@@@@@@@.......@@@@@@@@@......@@@@@@@@@@@@@@@@@@@@@@@@@@@@@
@@@@@@@@@@@@@@.....@@@@@@@..........@@@@@@@@@@@@@@@@@@@@@@@@@@@@
@@@@@@@@@@@@@@@...@@@@@@.............@@@@@@@@@@@@@@@@@@@@@@@@@@@
@@@@@@@@@@@@@@@@..@@@@@.............@@@@@@@@@@@@@@@@@@@@@@@@@@@@
@@@@@@@@@@@@@@@@@..@@@@............@@@@@@@@@@@@@@@@@@@@@@@@@@@@@
@@@@@@@@@@@@@@@@@@..@@@...........@@@@@@@@@@@@@@@@@@@@@@@@@@@@@@
@@@@@@@@@@@@@@@@@@@..@@..........@@@@@@@@@@@@@@@@@@@@@@@@@@@@@@@
@@@@@@@@@@@@@@@@@@@@..@.........@@@@@@@@@@@@@@@@@@@@@@@@@@@@@@@@
@@@@@@@@@@@@@@@@@@@@@..........@@@@@@@@@@@@@@@@@@@@@@@@@@@@@@@@@
@@@@@@@@@@@@@@@@@@@@@@........@@@@@@@@@@@@@@@@@@@@@@@@@@@@@@@@@@
@@@@@@@@@@@@@@@@@@@@@@@......@@@@@@@@@@@@@@@@@@@@@@@@@@@@@@@@@@@
@@@@@@@@@@@@@@@@@@@@@@@@....@@@@@@@@@@@@@@@@@@@@@@@@@@@@@@@@@@@@
@@@@@@@@@@@@@@@@@@@@@@@@@@@@@@@@@@@@@@@@@@@@@@@@@@@@@@@@@@@@@@@@
@@@@@@@@@@@@@@@@@@@@@@@@@@@@@@@@@@@@@@@@@@@@@@@@@@@@@@@@@@@@@@@@
