type octile
height 86
width 92
map
@@@@@@@@@@@@@@@@@@@@@@@@@@@@@@@@@@@@@@@@@@@@@@@@@@@@@@@@@@@@@@@@@@@@@@@@@@@@@@@@@@@@@@@@@@@@
@@@@@@@@@@@@@@@@@@@@@@@@@@@@@@@@@@@@@@@@@@@@@@@@@@@@@@@@@@@@@@@@@@@@@@@@@@@@@@@@@@@@@@@@@@@@
@@@@@@@@@@@@@@@@@@@@@@@@@@@@@@@@@@@@@@@@@@@@@@@@@@@@@@@@@@@@@@@@@@@@@@@@@@@@@@@@@@@@@@@@@@@@
@@@@@@@@@@@@@@@@@@@@@@@@@@@@@@@@@@@@@@@@@@@@@@@@@@@@@@@@@@@@@@@@@@@@@@@@@@@@@@@@@@@@@@@@@@@@
@@@@@@@@@@@@@@@@@@@@@@@@@@@@@@@@@@@@@@@@@@@@@@@@@@@@@@@@@@@@@@@@@@@@@@@@@@@@@@@@@@@@@@@@@@@@
@@@@@@@@@@@@@@@@@@@@@@@@@@@@@@@@@@@@@@@@@@@@@@@@@@@@@@@@@@@@@@@@@@@@@@@@@@@@@@@@@@@@@@@@@@@@
@@@@@@@@@@@@@@@@@@@@@@@@@@@@@@@@@@@@@@@@@@@@@@@@@@@@@@@@@@@@@@@@@@@@@@@@@@@@@@@@@@@@@@@@@@@@
@@@@@@@@@@@@@@@@@@@@@@@@@@@@@@@@@@@@@@@@@@@@@@@@@@@@@@@@@@@@@@@@@@@@@@@@@@@@@@@@@@@@@@@@@@@@
@@@@@@@@@@@@@@@@@@@@@@@@@@@@@@@@@@@@@@@@@@@@@@@@@@@@@@@@@@@@@@@@@@@@@@@@@@@@@@@@@@@@@@@@@@@@
@@@@@@@@@@@@@@@@@@@@@@@@@@@@@@@@@@@@@@@@@@@@@@@@@@@@@@@@@@@@@@@@@@@@@@@@@@@@@@@@@@@@@@@@@@@@
@@@@@@@@@@@@@@@@@@@@@@@@@@@@@@@@@@@@@@@@@@@@@@@@@@@@@@@@@@@@@@@@@@@@@@@@@@@@@@@@@@@@@@@@@@@@
@@@@@@@@@@@@@@@@@@@@@@@@@@@@@@@@@@@@@@@@@@@@@@@@@@@@@@@@@@@@@@@@@@@@@@@@@@@@@@@@@@@@@@@@@@@@
@@@@@@@@@@@@@@@@@@@@@@@@@@@@@@@@@@@@@@@@@@@@@@@@@@@@@@@@@@@@@@@@@@@@@@@@@@@@@@@@@@@@@@@@@@@@
@@@@@@@@@@@@@@@@@@@@@@@@@@@@@@@@@@@@@@@@@@@@@@@@@@@@@@@.@@@@@@@@@@@@@@@@@@@@@@@@@@@@@@..@@@@
@@@@@@@@@@@@@@@@@@@@@@@@@@@@@@@@@@@@@@@@@@@@@@@@@@@@@@@..@@@@@@@@@@@@@@@@@@@@@@@@@@@@...@@@@
@@@@@@@@@@@@@@@@@@@@@@@@@@@@@@@@@@@@@@@@@@@@@@@@@@@@@@....@@@@@@@@@@@@@@@@@@@@@@@@@@@....@@@
@@@@@@@@@@@@@@@@@@@@@@@@@@@@@@@@@@@@@@@@@@@@@@@@@@@@...@@..@@@@@@@@@@@@@@@@@@@@@@@@@......@@
@@@@@@@@@@@@@@@@@@@@@@@@@@@@@@@@@@@@@@@@.@@@@@@@@@@....@@...@@@@@@@@@@@@@@@@@@@@@@@.......@@
@@@@@@@@@@@@@@@@@@@@@@@@@@@@@@@@@@@@@@@...@@@@@@@@.........@@@@@@@@@@@@@@@@@@@@@@@........@@
@@@@@@@@@@@@@@@@@@@@@@@@@@@@@@@@@@@@@@......@@@@@.........@@@@@@@@@@@@@@@@@@@@@@@.........@@
@@@@@@@@@@@@@@@@@@@@@@@@@@@@@@@@@@@@@@.......@@@@@.......@@@@@@@@@@@@@@@@@@@@@@@..........@@
@@@@@@@@@@@@@@@@@@@@@@@@@@@@@@@@@@@..@@.......@@@@@.....@@@@@@@@@@@@@@@@@@@@@@@..........@@@
@@@@@@@@@@@@@@@@@@@@@@@@@@@@@@@@@@....@@.......@@@.....@@@@@.@@@@@@@@@@@@@@@@@..........@@@@
@@@@@@@@@@@@@@@@@@@@@@@@@@@@@@@@@......@@.......@......@@@@..@@.@@@@@@@@@@@@@..........@@@@@
@@@@@@@@@@@@@@@@@@@@@@@@@@@@@@@@........@@...........@@@.........@@@@@@@@@@@..........@@@@@@
@@@@@@@@@@@@@@@@@@@@@@@@@@@@@@@..........@@.........@@@@.........@@.@@@@@@@..........@@@@@@@
@@@@@@@@@@@@@@@@@@@@@@@@@@@@@@............@@........@@...........@@..@@@@@..........@@@@@@@@
@@@@@@@@@@@@@@@@@@@@@@@@@@@@@..............@@....................@@...@@@..........@@@@@@@@@
@@@@@@@@@@@@@@@@@@@@@@@@@@@@................@@...................@@.@@@@@@........@@@@@@@@@@
@@@@@@@@@@@@@@@@@@@@@@@@@@@..................@@.....................@@@@@@@.......@@@@@@@@@@
@@@@@@@@@@@@@@@@@@@@@@@@@@....................@@@...................@@@.@@@@...@@@@@@@@@@@@@
@@@@@@@@@@@@@@@@@@@@@@@@@.......................@............@@.....@@@.......@@@@@@@@@@@@@@
@@@@@@@@@@@@@@@@@@@@@@@@.......................@@..........@@@@@.............@@@@@@@@@@@@@@@
@@@@@@@@@@@@@@@@@@@@@@@@......................@@...........@@@@@@...........@@@@@@@@@@@@@@@@
@@@@@@@@@@@@@@@@@@@.@@@@......................@..............@@@@@..........@@@@@@@@@@@@@@@@
@@@@@@@@@@@@@@@@@@...@@@@...................@.................@@@........@@@@@@@@@@@@@@@@@@@
@@@@@@@@@@@@@@@@@@....@@@..................@@..................@.......@@@@@@@@@@@@@@@@@@@@@
@@@@@@@@@@@@@@@@@.....@@@.................@@...........................@@@@@@@@@@@@@@@@@@@@@
@@@@@@@@@@@@@@@@......@@@@...............@@............@...............@@@@@@@@@@@@@@@@@@@@@
@@@@@@@@@@@@@@@@.....@@@@@@............@@@............@@@@..............@@@@@@@@@@@@@@@@@@@@
@@@@@@@@@@@@@@@......@@@@@@@..........@@.............@@..@@..............@@@@@@@@@@@@@@@@@@@
@@@@@@@@@@@@@@@.....@@@@@@@@@........@@...................@@.............@@@@@@@@@@@@@@@@@@@
@@@@@@@@@@@@@@......@@@@.@@@@@......@@.....................@@............@@@@@@@@@@@@@@@@@@@
@@@@@@@@@@@@@@.....@@@@...@@@@@....@@............@@@........@@..........@@@@@@@@@@@@@@@@@@@@
@@@@@@@@@@@@@@@....@@@....@@@@@@..@@............@@@@.........@@........@@@@@@@@@@@@@@@@@@@@@
@@@@@@@@@@@@@@@...@@.....@@@@@@@@@@............@@.............@@......@@@@@@@@@@@@@@@@@@@@@@
@@@@@@@@@@@@@@....@@....@@@@@@@@@@............@@...............@@....@@@@@@@@@@@@@@@@@@@@@@@
@@@@@@@@@@@@......@..@@@@@@@@@@@@............@@.................@@..@@@@@@@@@@@@@@@@@@@@@@@@
@@@@@@@@@@..........@@@@@@@@@@@@@...........@@...................@@@@@@@@@@@@@@@@@@@@@@@@@@@
@@@@@@@@@@@.........@@@@@@@@@@@@............@.....................@@@@@@@@@@@@@@@@@@@@@@@@@@
@@@@@@@@@@@@.........@@@@@@@@@@..................................@@@@@@@@@@@@@@@@@@@@@@@@@@@
@@@@@@@@@@@@.........@@@@@@@@@..................................@@@@@@@@@@@@@@@@@@@@@@@@@@@@
@@@@@@@@@@@..........@@@@@@@.........@@@@......................@@@@@@@@@@@@@@@@@@@@@@@@@@@@@
@@@@@@@@@@.............@@@@@.........@@@@@....................@@@@@@@@@@@@@@@@@@@@@@@@@@@@@@
@@@@@@@@@...............@@@..........@@@@@@..................@@@@@@@@@@@@@@@@@@@@@@@@@@@@@@@
@@@@@@@@............................@@@@@@@@................@@@@@@@@@@@@@@@@@@@@@@@@@@@@@@@@
@@@@@@@@@...........................@@@@@@@@@..............@@@@@@@@@@@@@@@@@@@@@@@@@@@@@@@@@
@@@@@@@@@@............................@@@@@@@@............@@@@@@@@@@@@@@@@@@@@@@@@@@@@@@@@@@
@@@@@@@@@@@............................@@@@@@@@..........@@@@@@@@@@@@@@@@@@@@@@@@@@@@@@@@@@@
@@@@@@@@@@@@...........................@@@@@@@@@........@@@@@@@@@@@@@@@@@@@@@@@@@@@@@@@@@@@@
@@@@@@@@@@@@@..........................@@@@@@@@@@.....@@@@@@@@@@@@@@@@@@@@@@@@@@@@@@@@@@@@@@
@@@@@@@@@@@@@@.........................@@@@@@@@@@@@@@@@@@@@@@@@@@@@@@@@@@@@@@@@@@@@@@@@@@@@@
@@@@@@@@@@@@@@@......................@@@@@@@@@@@@@@@@@@@@@@@@@@@@@@@@@@@@@@@@@@@@@@@@@@@@@@@
@@@@@@@@@@@@@@@@...................@@@@@@@@@@@@@@@@@@@@@@@@@@@@@@@@@@@@@@@@@@@@@@@@@@@@@@@@@
@@@@@@@@@@@@@@@@@............@@@....@@@@@@@@@@@@@@@@@@@@@@@@@@@@@@@@@@@@@@@@@@@@@@@@@@@@@@@@
@@@@@@@@@@@@@@@@@@...........@@@.@@..@@@@@@@@@@@@@@@@@@@@@@@@@@@@@@@@@@@@@@@@@@@@@@@@@@@@@@@
@@@@@@@@@@@@@@@@@@@..........@@@@@@..@@@@@.@@@@@@@@@@@@@@@@@@@@@@@@@@@@@@@@@@@@@@@@@@@@@@@@@
@@@@@@@@@@@@@@@@@@@@....@@@..@@@@@@..@@@.....@@@@@@@@@@@@@@@@@@@@@@@@@@@@@@@@@@@@@@@@@@@@@@@
@@@@@@@@@@@@@@@@@@@@@...@@@@.@@@@@...@@@.....@@@@@@@@@@@@@@@@@@@@@@@@@@@@@@@@@@@@@@@@@@@@@@@
@@@@@@@@@@@@@@@@@@@@@@.@@@@@@@@@@@@.........@@@@@@@@@@@@@@@@@@@@@@@@@@@@@@@@@@@@@@@@@@@@@@@@
@@@@@@@@@@@@@@@@@@@@@@@@@@@@@.@@@@@........@@@@@@@@@@@@@@@@@@@@@@@@@@@@@@@@@@@@@@@@@@@@@@@@@
@@@@@@@@@@@@@@@@@@@@@@@@@@@@@.............@@@@@@@@@@@@@@@@@@@@@@@@@@@@@@@@@@@@@@@@@@@@@@@@@@
@@@@@@@@@@@@@@@@@@@@@@@@@@@@.............@@@@@@@@@@@@@@@@@@@@@@@@@@@@@@@@@@@@@@@@@@@@@@@@@@@
@@@@@@@@@@@@@@@@@@@@@@@@@@..............@@@@@@@@@@@@@@@@@@@@@@@@@@@@@@@@@@@@@@@@@@@@@@@@@@@@
@@@@@@@@@@@@@@@@@@@@@@@@@@@............@@@@@@@@@@@@@@@@@@@@@@@@@@@@@@@@@@@@@@@@@@@@@@@@@@@@@
@@@@@@@@@@@@@@@@@@@@@@@@@@@@..........@@@@@@@@@@@@@@@@@@@@@@@@@@@@@@@@@@@@@@@@@@@@@@@@@@@@@@
@@@@@@@@@@@@@@@@@@@@@@@@@@@@@........@@@@@@@@@@@@@@@@@@@@@@@@@@@@@@@@@@@@@@@@@@@@@@@@@@@@@@@
@@@@@@@@@@@@@@@@@@@@@@@@@@@@@@......@@@@@@@@@@@@@@@@@@@@@@@@@@@@@@@@@@@@@@@@@@@@@@@@@@@@@@@@
@@@@@@@@@@@@@@@@@@@@@@@@@@@@@@@@..@@@@@@@@@@@@@@@@@@@@@@@@@@@@@@@@@@@@@@@@@@@@@@@@@@@@@@@@@@
@@@@@@@@@@@@@@@@@@@@@@@@@@@@@@@@@@@@@@@@@@@@@@@@@@@@@@@@@@@@@@@@@@@@@@@@@@@@@@@@@@@@@@@@@@@@
@@@@@@@@@@@@@@@@@@@@@@@@@@@@@@@@@@@@@@@@@@@@@@@@@@@@@@@@@@@@@@@@@@@@@@@@@@@@@@@@@@@@@@@@@@@@
@@@@@@@@@@@@@@@@@@@@@@@@@@@@@@@@@@@@@@@@@@@@@@@@@@@@@@@@@@@@@@@@@@@@@@@@@@@@@@@@@@@@@@@@@@@@
@@@@@@@@@@@@@@@@@@@@@@@@@@@@@@@@@@@@@@@@@@@@@@@@@@@@@@@@@@@@@@@@@@@@@@@@@@@@@@@@@@@@@@@@@@@@
@@@@@@@@@@@@@@@@@@@@@@@@@@@@@@@@@@@@@@@@@@@@@@@@@@@@@@@@@@@@@@@@@@@@@@@@@@@@@@@@@@@@@@@@@@@@
@@@@@@@@@@@@@@@@@@@@@@@@@@@@@@@@@@@@@@@@@@@@@@@@@@@@@@@@@@@@@@@@@@@@@@@@@@@@@@@@@@@@@@@@@@@@
@@@@@@@@@@@@@@@@@@@@@@@@@@@@@@@@@@@@@@@@@@@@@@@@@@@@@@@@@@@@@@@@@@@@@@@@@@@@@@@@@@@@@@@@@@@@
