type octile
height 118
width 112
map
@@@@@@@@@@@@@@@@@@@@@@@@@@@@@@@@@@@@@@@@@@@@@@@@@@@@@@@@@@@@@@@@@@@@@@@@@@@@@@@@@@@@@@@@@@@@@@@@@@@@@@@@@@@@@@@@
@@@@@@@@@@@@@@@@@@@@@@@@@@@@@@@@@@@@@@@@@@@@@@@@@@@@@@@@@@@@@@@@@@@@@@@@@@@@@@@@@@@@@@@@@@@@@@@@@@@@@@@@@@@@@@@@
@@@@@@@@@@@@@@@@@@@@@@@@@@@@@@@@@@@@@@@@@@@@@@@@@@@@@@@@@@@@@@@@@@@@@@@@@@@@@@@@@@@@@@@@@@@@@@@@@@@@@@@@@@@@@@@@
@@@@@@@@@@@@@@@@@@@@@@@@@@@@@@@@@@@@@@@@@@@@@@@@@@@@@@@@@@@@@@@@@@@@@@@@@@@@@@@@@@@@@@@@@@@@@@@@@@@@@@@@@@@@@@@@
@@@@@@@@@@@@@@@@@@@@@@@@@@@@@@@@@@@@@@@@@@@@@@@@@@@@@@@@@@@@@@@@@@@@@@@@@@@@@@@@@@@@@@@@@@@@@@@@@@@@@@@@@@@@@@@@
@@@@@@@@@@@@@@@@@@@@@@@@@@@@@@@@@@@@@@@@@@@@@@@@@@@@@@@@@@@@@@@@@@@@@@@@@@@@@@@@@@@@@@@@@@@@@@@@@@@@@@@@@@@@@@@@
@@@@@@@@@@@@@@@@@@@@@@@@@@@@@@@@@@@@@@@@@@@@@@@@@@@@@@@@@@@@@@@@@@@@@@@@@@@@@@@@@@@@@@@@@@@@@@@@@@@@@@@@@@@@@@@@
@@@@@@@@@@@@@@@@@@@@@@@@@@@@@@@@@@@@@@@@@@@@@@@@@@@@@@@@@@@@@@@@@@@@@@@@@@@@@@@@@@@@@@@@@@@@@@@@@@@@@@@@@@@@@@@@
@@@@@@@@@@@@@@@@@@@@@@@@@@@@@@@@@@@@@@@@@@@@@@@@@@@@@@@@@@@@@@@@@@@@@@@@@@@@@@@@@@@@@@@@@@@@@@@@@@@@@@@@@@@@@@@@
@@@@@@@@@@@@@@@@@@@@@@@@@@@@@@@@@@@@@@@@@@@@@@@@@@@@@@@@@@@@@@@@@@@@@@@@@@@@@@@@@@@@@@@@@@@@@@@@@@@@@@@@@@@@@@@@
@@@@@@@@@@@@@@@@@@@@@@@@@@@@@@@@@@@@@@@@@@@@@@@@@@@@@@@@@@@@@@@@@@@@..@@@@@@@@@@@@@@@@@@@@@@@@@@@@@@@@@@@@@@@@@@
@@@@@@@@@@@@@@@@@@@@@@@@@@@@@@@@@@@@@@@@@@@@@@@@@@@@@@@@@@@@@@@@@@@....@@@@@@@@@@@@@@@@@@@@@@@@@@@@@@@@@@@@@@@@@
@@@@@@@@@@@@@@@@@@@@@@@@@@@@@@@@@@@@@@@@@@@@@@@@@@@@@@@@@@@@@@@@@@......@@@@@@@@@@@@@@@@@@@@@@@@@@@@@@@@@@@@@@@@
@@@@@@@@@@@@@@@@@@@@@@@@@@@@@@@@@@@@@@@@@@@@@@@@@@@@@@@@@@@@@@@@@........@@@@@@@@@@@@@@@@@@@@@@@@@@@@@@@@@@@@@@@
@@@@@@@@@@@@@@@@@@@@@@@@@@@@@@@@@@@@@@@@@@@@@@@@@@@@@@@@@@@@@@@@..........@@@@@@@@@@@@@@@@@@@@@@@@@@@@@@@@@@@@@@
@@@@@@@@@@@@@@@@@@@@@@@@@@@@@@@@@@@@@@@@@@@@@@@@@@@@@@@@@@@@@@@............@@@@@@@@@@@@@@@@@@@@@@@@@@@@@@@@@@@@@
@@@@@@@@@@@@@@@@@@@@@@@@@@@@@@@@@@@@@@@@@@@@@@@@@@@@@@@@@@@@@@......@.......@@@@@@@@@@@@@@@@@@@@@@@@@@@@@@@@@@@@
@@@@@@@@@@@@@@@@@@@@@@@@@@@@@@@@@@@@@@@@@@@@@@@@@@@@@@@@@@@@@......@@@.......@@@@@@@@@@@@@@@@@@@@@@@@@@@@@@@@@@@
@@@@@@@@@@@@@@@@@@@@@@@@@@@@@@@@@@@@@@@@@@@@@@@@@@@@@@@@@@@@......@@@@@.......@@@@@@@@@@@@@@@@@@@@@@@@@@@@@@@@@@
@@@@@@@@@@@@@@@@@@@@@@@@@@@@@@@@@@@@@@@@@@@@@@@@@@@@@@@@@@@......@@@@@@@.......@@@@@@@@@@@@@@@@@@@@@@@@@@@@@@@@@
@@@@@@@@@@@@@@@@@@@@@@@@@@@@@@@@@@@@@@@@@@@@@@@@@@@@@@@@@@......@@@@@@@@@.......@@@@@@@@@@@@@@@@@@@@@@@@@@@@@@@@
@@@@@@@@@@@@@@@@@@@@@@@@@@@@@@@@@@@@@@@@@@@@@@@@@@@@@@@@@......@@@@@@@@@@@........@@@@@@@@@@@@@@@@@@@@@@@@@@@@@@
@@@@@@@@@@@@@@@@@@@@@@@@@@@@@@@@@@@@@@@@@@@@@@@@@@@@@@@@......@@@@@@@@@@@@@........@@@@@@@@@@@@@@@@@@@@@@@@@@@@@
@@@@@@@@@@@@@@@@@@@@@@@@@@@@@@@@@@@@@@@@@@@@@@@@@@@@@@@......@@@@@@@@..@@@@@........@@@@@@@@@@@@@@@@@@@@@@@@@@@@
@@@@@@@@@@@@@@@@@@@@@@@@@@@@@@@@@@@@@@@@@@@@@@@@@@@@@@......@@@@@@@....@@@@@@........@@@@@@@@@@@@@@@@@@@@@@@@@@@
@@@@@@@@@@@@@@@@@@@@@@@@@@@@@@@@@@@@@@@@@@@@@@@@@@@@@......@@@@@@@......@@@@@@........@@@@@@@@@@@@@@@@@@@@@@@@@@
@@@@@@@@@@@@@@@@@@@@@@@@@@@@@@@@@@@@@@@@@@@@@@@@@@@@......@@@@@@@........@@@@@@........@@@@@@@@@@@@@@@@@@@@@@@@@
@@@@@@@@@@@@@@@@@@@@@@@@@@@@@@@@@@@@@@@@@@@@@@@@@@.......@@@@@@@@.........@@@@@@........@@@@@@@@@@@@@@@@@@@@@@@@
@@@@@@@@@@@@@@@@@@@@@@@@@@@@@@@@@@@@@@@@@@@@@@@@@.......@@@@@@@@.....@@.....@@@@@........@@@@@@@@@@@@@@@@@@@@@@@
@@@@@@@@@@@@@@@@@@@@@@@@@@@@@@@@@@@@@@@@@@@@@@@@.......@@@@@@@......@@@@.....@@@@@........@@@@@@@@@@@@@@@@@@@@@@
@@@@@@@@@@@@@@@@@@@@@@@@@@@@@@@@@@@@@@@@@@@@@@@.......@@@@@........@@@@@@.....@@@@@........@@@@@@@@@@@@@@@@@@@@@
@@@@@@@@@@@@@@@@@@@@@@@@@@@@@@@@@@@@@@@@@@.@@@.......@@@@@........@@@@@@@@.....@@@@@........@@@@@@@@@@@@@@@@@@@@
@@@@@@@@@@@@@@@@@@@@@@@@@@@@@@@@@@@@@@@@@...@@........@@@@@......@@@@@@@@@......@@@@@........@@@@@@@@@@@@@@@@@@@
@@@@@@@@@@@@@@@@@@@@@@@@@@@@@@@@@@@@@@@@.....@.........@@@@@....@@@@@@@@.........@@@@@@.......@@@@@@@@@@@@@@@@@@
@@@@@@@@@@@@@@@@@@@@@@@@@@@@@@@@@@@@@@@.....@@.@@@......@@@@@..@@@@@@@@@..........@@@@@@.......@@@@@@@@@@@@@@@@@
@@@@@@@@@@@@@@@@@@@@@@@@@.........@@@@.....@@@@@@@@......@@@@@@@@@@@@@@@...........@@@@@@.......@@@@@@@@@@@@@@@@
@@@@@@@@@@@@@@@@@@@@@@.............@@@.....@@@@@@@........@@@@@@@@@@@.........@@...@@@@@@@.......@@@@@@@@@@@@@@@
@@@@@@@@@@@@@@@@@@@@...............@@@....@@@@.@@..........@@@@@@@@@.........@@@@....@@@@@@.......@@@@@@@@@@@@@@
@@@@@@@@@@@@@@@@@@@...............@@@@....@@@@..............@@@@@@@.........@@@@@......@@@@@.......@@@@@@@@@@@@@
@@@@@@@@@@@@@@@@@@.................@@....@@@@@......@........@@@@@@........@@@@@@.......@@@@........@@@@@@@@@@@@
@@@@@@@@@@@@@@@@@........................@@@@@.....@@@........@@@@@@......@@@@@@@........@@@@........@@@@@@..@@@
@@@@@@@@@@@@@@@@.........................@@@@@.................@@@@@@....@@@@@@@@.........@@@@........@@@@...@@@
@@@@@@@@@@@@@@@.........................@@@@@..........@@@......@@@@@@..@@@@@@@@..........@@@@@........@@....@@@
@@@@@@@@@@@@@@.........................@@@@@..........@@@@@......@@@@@@@@@@@@@.............@@@@@............@@@@
@@@@@@@@@@@@@@.........@@@@@@@..........@@@............@@@@.......@@@@@@@@@@@.........@@@...@@@@@..........@@@@@
@@@@@@@@@@@@@.........@@@@@@@@@..........@@.............@@.........@@@@@@@@..........@@@@...@@@@@@.........@@@@@
@@@@@@@@@@@@@.........@@@@@@@@@@..........@.........................@@@@@@..........@@@@@@...@@@@@@.........@@@@
@@@@@@@@@@@@@.........@@@@@...@@@.........@.................@@.......@@@@@@........@@@@@@@.....@@@@@@........@@@
@@@@@@@@@@@@@.........@@@@@@...@@@........@@...............@@@........@@@@@@......@@@@@@@@......@@@@@........@@@
@@@@@@@@@@@@@@........@@@@@@....@@@........@@..........................@@@@@@....@@@@@@@@.......@@@@.........@@@
@@@@@@@@@@@@@@.........@@@@@.....@@@........@..@@...............@@.......@@@@@..@@@@@@@@.......@@@@.........@@@@
@@@@@@@@@@@@@@@........@@@@.......@@@.......@..@@@.............@@@@.......@@@@@@@@@@@@@.......@@@@.........@@@@@
@@@@@@@@@@@@@@@.........@@@........@@@.........@@@.............@@@@........@@@@@@@@@@@........@@@.........@@@@@@
@@@@@@@@@@@@@@@@........@@@.........@@..........................@@..........@@@@@@@...........@@.........@@@@@@@
@@@@@@@@@@@@@@@@..........@@.........@@......................................@@@@@.............@........@@@@@@@@
@@@@@@@@@@@@@@@@@..........@@.........@..............................@........@@@@@......@@@...........@@@@@@@@@
@@@@@@@@@@@@@@@@@@..........@@........@@............................@@@........@@@@@....@@@@..........@@@@@@@@@@
@@@@@@@@@@@@@@@@@@@..........@@.................................................@@@@@..@@@@@.........@@@@@@@@@@@
@@@@@@@@@@@@@@@@@@@@..........@.........................@@..............@@@......@@@@@@@@@@.........@@@@@@@@@@@@
@@@@@@@@@@@@@@@@@@@@@.........@........................@@@.............@@@@@......@@@@@@@@.........@@@@@@@@@@@@@
@@@@@@@@@@@@@@@@@@@@@@........@@.......................@@@..............@@@........@@@@@@.........@@@@@@@@@@@@@@
@@@@@@@@@@@@@@.@@..@@@@........@.........................................@..........@@@@.........@@@@@@@@@@@@@@@
@@@@@@@@@@@@@.......@@@@.......@@....................................................@@.........@@@@@@@@@@@@@@@@
@@@@@@@@@@@@.........@@@@.......@............................................@@................@@@@@@@@@@@@@@@@@
@@@@@@@@@@@...........@@@@..................................................@@@...............@@@@@@@@@@@@@@@@@@
@@@@@@@@@@.............@@@...................................................................@@@@@@@@@@@@@@@@@@@
@@@@@@@@@...............@@.......................................@..............@@@.........@@@@@@@@@@@@@@@@@@@@
@@@@@@@@.................@@.....................................@@@............@@@@@.......@@@@@@@@@@@@@@@@@@@@@
@@@@@@@...................@.....................................@@@.............@@@@......@@@@@@@@@@@@@@@@@@@@@@
@@@@@@....@......................................................................@@......@@@@@@@@@@@@@@@@@@@@@@@
@@@@@....@@@..............@@.............................................................@@@@@@@@@@@@@@@@@@@@@@@
@@@@....@@@@@............@@@.............................................................@@@@@@@@@@@@@@@@@@@@@@@
@@@.....@@@@.............@@@@............................................................@@@@@@@@@@@@@@@@@@@@@@@
@@@@.....@@.............................................................................@@@@@@@@@@@@@@@@@@@@@@@@
@@@@@....................................................................@@.............@@@@@@@@@@@@@@@@@@@@@@@@
@@@@@@........@.........................................................@@@.............@@@@@@@@@@@@@@@@@@@@@@@@
@@@@@@@......@@@........................................................@@@@............@@@@@@@@@@@@@@@@@@@@@@@@
@@@@@@@@...............................................................................@@@@@@@@@@@@@@@@@@@@@@@@@
@@@@@@@@@........@@@..............@@@.................................................@@@@@@@@@@@@@@@@@@@@@@@@@@
@@@@@@@@@@......@@@@@.............@@@...............................................@@@@@@@@@@@@@@@@@@@@@@@@@@@@
@@@@@@@@@@@......@@@@.............@@@..............................................@@@@@@@@@@@@@@@@@@@@@@@@@@@@@
@@@@@@@@@@@@......@@..............................................................@@@@@@@@@@@@@@@@@@@@@@@@@@@@@@
@@@@@@@@@@@@@.....................................................................@@@@@@@@@@@@@@@@@@@@@@@@@@@@@@
@@@@@@@@@@@@@@........@@.........................................................@@@@@@@@@@@@@@@@@@@@@@@@@@@@@@@
@@@@@@@@@@@@@@@.......@@.........................................................@@@@@@@@@@@@@@@@@@@@@@@@@@@@@@@
@@@@@@@@@@@@@@@@................................................................@@@@@@@@@@@@@@@@@@@@@@@@@@@@@@@@
@@@@@@@@@@@@@@@@@.........@@...............@@...................................@@@@@@@@@@@@@@@@@@@@@@@@@@@@@@@@
@@@@@@@@@@@@@@@@@@........@@@.............@@@@.................................@@@@@@@@@@@@@@@@@@@@@@@@@@@@@@@@@
@@@@@@@@@@@@@@@@@@@.......................@@@@...............................@@@@@@@@@@@@@@@@@@@@@@@@@@@@@@@@@@@
@@@@@@@@@@@@@@@@@@@@........................................................@@@@@@@@@@@@@@@@@@@@@@@@@@@@@@@@@@@@
@@@@@@@@@@@@@@@@@@@@@......................................................@@@@@@@@@@@@@@@@@@@@@@@@@@@@@@@@@@@@@
@@@@@@@@@@@@@@@@@@@@@@.........@..........................................@@@@@@@@@@@@@@@@@@@@@@@@@@@@@@@@@@@@@@
@@@@@@@@@@@@@@@@@@@@@@@.......@@@........................................@@@@@@@@@@@@@@@@@@@@@@@@@@@@@@@@@@@@@@@
@@@@@@@@@@@@@@@@@@@@@@@@................................................@@@@@@@@@@@@@@@@@@@@@@@@@@@@@@@@@@@@@@@@
@@@@@@@@@@@@@@@@@@@@@@@@@.........@@@...............@..................@@@@@@@@@@@@@@@@@@@@@@@@@@@@@@@@@@@@@@@@@
@@@@@@@@@@@@@@@@@@@@@@@@@@........@@@..............@@@...............@@@@@@@@@@@@@@@@@@@@@@@@@@@@@@@@@@@@@@@@@@@
@@@@@@@@@@@@@@@@@@@@@@@@@@@........................@@@...........@@@@@@@@@@@@@@@@@@@@@@@@@@@@@@@@@@@@@@@@@@@@@@@
@@@@@@@@@@@@@@@@@@@@@@@@@@@@....................................@@@@@@@@@@@@@@@@@@@@@@@@@@@@@@@@@@@@@@@@@@@@@@@@
@@@@@@@@@@@@@@@@@@@@@@@@@@@@@..................................@@@@@@@@@@@@@@@@@@@@@@@@@@@@@@@@@@@@@@@@@@@@@@@@@
@@@@@@@@@@@@@@@@@@@@@@@@@@@@@@.........@......................@@@@@@@@@@@@@@@@@@@@@@@@@@@@@@@@@@@@@@@@@@@@@@@@@@
@@@@@@@@@@@@@@@@@@@@@@@@@@@@@@@........@@...................@@@@@@@@@@@@@@@@@@@@@@@@@@@@@@@@@@@@@@@@@@@@@@@@@@@@
@@@@@@@@@@@@@@@@@@@@@@@@@@@@@@@@..........................@@@@@@@@@@@@@@@@@@@@@@@@@@@@@@@@@@@@@@@@@@@@@@@@@@@@@@
@@@@@@@@@@@@@@@@@@@@@@@@@@@@@@@@@.........@@@...........@@@@@@@@@@@@@@@@@@@@@@@@@@@@@@@@@@@@@@@@@@@@@@@@@@@@@@@@
@@@@@@@@@@@@@@@@@@@@@@@@@@@@@@@@@@........@@@........@@@@@@@@@@@@@@@@@@@@@@@@@@@@@@@@@@@@@@@@@@@@@@@@@@@@@@@@@@@
@@@@@@@@@@@@@@@@@@@@@@@@@@@@@@@@@@@................@@@@@@@@@@@@@@@@@@@@@@@@@@@@@@@@@@@@@@@@@@@@@@@@@@@@@@@@@@@@@
@@@@@@@@@@@@@@@@@@@@@@@@@@@@@@@@@@@@@.............@@@@@@@@@@@@@@@@@@@@@@@@@@@@@@@@@@@@@@@@@@@@@@@@@@@@@@@@@@@@@@
@@@@@@@@@@@@@@@@@@@@@@@@@@@@@@@@@@@@@@@..........@@@@@@@@@@@@@@@@@@@@@@@@@@@@@@@@@@@@@@@@@@@@@@@@@@@@@@@@@@@@@@@
@@@@@@@@@@@@@@@@@@@@@@@@@@@@@@@@@@@@@@@@........@@@@@@@@@@@@@@@@@@@@@@@@@@@@@@@@@@@@@@@@@@@@@@@@@@@@@@@@@@@@@@@@
@@@@@@@@@@@@@@@@@@@@@@@@@@@@@@@@@@@@@@@@@.....@@@@@@@@@@@@@@@@@@@@@@@@@@@@@@@@@@@@@@@@@@@@@@@@@@@@@@@@@@@@@@@@@@
@@@@@@@@@@@@@@@@@@@@@@@@@@@@@@@@@@@@@@@@@@...@@@@@@@@@@@@@@@@@@@@@@@@@@@@@@@@@@@@@@@@@@@@@@@@@@@@@@@@@@@@@@@@@@@
@@@@@@@@@@@@@@@@@@@@@@@@@@@@@@@@@@@@@@@@@@@@@@@@@@@@@@@@@@@@@@@@@@@@@@@@@@@@@@@@@@@@@@@@@@@@@@@@@@@@@@@@@@@@@@@@
@@@@@@@@@@@@@@@@@@@@@@@@@@@@@@@@@@@@@@@@@@@@@@@@@@@@@@@@@@@@@@@@@@@@@@@@@@@@@@@@@@@@@@@@@@@@@@@@@@@@@@@@@@@@@@@@
@@@@@@@@@@@@@@@@@@@@@@@@@@@@@@@@@@@@@@@@@@@@@@@@@@@@@@@@@@@@@@@@@@@@@@@@@@@@@@@@@@@@@@@@@@@@@@@@@@@@@@@@@@@@@@@@
@@@@@@@@@@@@@@@@@@@@@@@@@@@@@@@@@@@@@@@@@@@@@@@@@@@@@@@@@@@@@@@@@@@@@@@@@@@@@@@@@@@@@@@@@@@@@@@@@@@@@@@@@@@@@@@@
@@@@@@@@@@@@@@@@@@@@@@@@@@@@@@@@@@@@@@@@@@@@@@@@@@@@@@@@@@@@@@@@@@@@@@@@@@@@@@@@@@@@@@@@@@@@@@@@@@@@@@@@@@@@@@@@
@@@@@@@@@@@@@@@@@@@@@@@@@@@@@@@@@@@@@@@@@@@@@@@@@@@@@@@@@@@@@@@@@@@@@@@@@@@@@@@@@@@@@@@@@@@@@@@@@@@@@@@@@@@@@@@@
@@@@@@@@@@@@@@@@@@@@@@@@@@@@@@@@@@@@@@@@@@@@@@@@@@@@@@@@@@@@@@@@@@@@@@@@@@@@@@@@@@@@@@@@@@@@@@@@@@@@@@@@@@@@@@@@
@@@@@@@@@@@@@@@@@@@@@@@@@@@@@@@@@@@@@@@@@@@@@@@@@@@@@@@@@@@@@@@@@@@@@@@@@@@@@@@@@@@@@@@@@@@@@@@@@@@@@@@@@@@@@@@@
