type octile
height 59
width 56
map
@@@@@@@@@@@@@@@@@@@@@@@@@@@@@@@@@@@@@@@@@@@@@@@@@@@@@@@@
@@@@@@@@@@@@@@@@@@@@@@@@@@@@@@@@@@@@@@@@@@@@@@@@@@@@@@@@
@@@@@@@@@@@@@@@@@@@@@@@@@@@@@@@@@@@@@@@@@@@@@@@@@@@@@@@@
@@@@@@@@@@@@@@@@@@@@@@@@@@@@@@@@@@@@@@@@@@@@@@@@@@@@@@@@
@@@@@@@@@@@@@@@@@@@@@@@@@@@@@@@@@@@@@@@@@@@@@@@@@@@@@@@@
@@@@@@@@@@@@@@@@@@@@@@@@@@@@@@@@@@@@@@@@@@@@@@@@@@@@@@@@
@@@@@@@@@@@@@@@@@@@@@@@@@@@@@@@@@@@@@@@@@@@@@@@@@@@@@@@@
@@@@@@@@@@@@@@@@@@@@@..@@@@@@@@@@@@@@@@@@@@@@@@@@@@@@@@@
@@@@@@@@@@@@@@@@@@@@....@@@@@@@@@@@@@@@@@@@@@@@@@@@@@@@@
@@@@@@@@@@@@@@@@@@@......@@@@@@@@@@@@@@@@@@@@@@@@@@@@@@@
@@@@@@@@@@@@@@@@@@........@@@@@@@@@@@@@@@@@@@@@@@@@@@@@@
@@@@@@@@@@@@@@@@@..........@@@@@@@@@@@@@@@@@@@@@@@@@@@@@
@@@@@@@@@@@@@@@@...........@@@@@@@@@@@@@@@@@@@@@@@@@@@@@
@@@@@@@@@@@@@@@...........@@@@@@@@@@@@@@@@@@@@@@@@@@@@@@
@@@@@@@@@@@@@@@..........@@@@@@@@@@.....@@@@@@@@@@@@@@@@
@@@@@@@@@@@@@@..........@@@@@@@@@@.......@@@@@@@@@@@@@@@
@@@@@@@@@@@@@@.........@@@@@@@@@@..........@@@@@@@@@@@@@
@@@@@@@@@@@@@.........@@@@@@@@@@....@.......@@@@@@@@@@@@
@@@@@@@@@@@@.........@@@@@@@@@@@@..@@......@@@@@@@@@@@@@
@@@@@@@@@@@.........@@@@@@@@@@@@@@@@@@@@@.....@@@@@@@@@@
@@@@@@@@@@..........@@@@@@....@@@@@@@@@@@......@@@@@@@@@
@@@@@@@@@..........@@@@........@@@@@@@@@........@@@@@@@@
@@@@@@@@@..........@@............................@@@@@@@
@@@@@@@@@........................................@@@@@@@
@@@@@@@@@......................................@@@@@@@@@
@@@@@@@.........................@@@@..........@@@@@@@@@@
@@@@@@@....................@@@@@@@@@@.........@@@@@@@@@@
@@@@@@@.................@@@@@@@@@@@@@@........@@@@@@@@@@
@@@@@@@..............@@@@@@@@@@@@@@@@@........@@@@@@@@@@
@@@@@@@.............@@@@@@@@@@@@@@@@@@@.......@@@@@@@@@@
@@@@@@@............@@@@@@@@@@@@@@@@@@@@.......@@@@@@@@@@
@@@@@@@.......@@...@@@@@@@@@@@@@@@@@@@@........@@@@@@@@@
@@@@@@@...@@@@@@...@@@@@@@@@@@@@@@@@@@@@.......@@@@@@@@@
@@@@@@@..@@@@@@@@.@@@@@@@@@@@@@@@@@@@@@@.......@@@@@@@@@
@@@@@@@....@@@@@@.@@@@@@@@@@@@@@@@@@@@@@............@@@@
@@@@@@......@@@@@.@@@@@@@@@@@@@@@@@@@@@@............@@@@
@@@@@@.......@@@@.@@@@@@@@@@@@@@@@@@@@@@............@@@@
@@@@@@........@@@.@@@@@@@@@@@@@@@@@@@@@@............@@@@
@@@@@@.............@@@@@@@@@@@@@@@@@@@@.............@@@@
@@@@@..............@@@@@@@@@@@@@@@@@@@@.............@@@@
@@@@@......@@@......@@@@@@@@@@@@@@@@@@..............@@@@
@@@@@......@@@@......@@@@@@@@@@@@@@@@@..............@@@@
@@@@@.......@@@......@@@@@@@@@@@@@@@@@..............@@@@
@@@@@@.................@@@@@@@@@@@@@@@@.............@@@@
@@@@@@@.................@@@@@@@@@@@@@@..............@@@@
@@@@@@@@...................@@@@@@@@@................@@@@
@@@@@@@@@.....................@@...................@@@@@
@@@@@@@@@@........................................@@@@@@
@@@@@@@@@@@....................................@.@@@@@@@
@@@@@@@@@@@@@.................................@@@@@@@@@@
@@@@@@@@@@@@@@@.............................@@@@@@@@@@@@
@@@@@@@@@@@@@@@@..........................@@@@@@@@@@@@@@
@@@@@@@@@@@@@@@@@.......................@@@@@@@@@@@@@@@@
@@@@@@@@@@@@@@@@@@@....................@@@@@@@@@@@@@@@@@
@@@@@@@@@@@@@@@@@@@@@@...............@@@@@@@@@@@@@@@@@@@
@@@@@@@@@@@@@@@@@@@@@@@@@@@@@@@@@@@@@@@@@@@@@@@@@@@@@@@@
@@@@@@@@@@@@@@@@@@@@@@@@@@@@@@@@@@@@@@@@@@@@@@@@@@@@@@@@
@@@@@@@@@@@@@@@@@@@@@@@@@@@@@@@@@@@@@@@@@@@@@@@@@@@@@@@@
@@@@@@@@@@@@@@@@@@@@@@@@@@@@@@@@@@@@@@@@@@@@@@@@@@@@@@@@
