type octile
height 59
width 52
map
@@@@@@@@@@@@@@@@@@@@@@@@@@@@@@@@@@@@@@@@@@@@@@@@@@@@
@@@@@@@@@@@@@@@@@@@@@@@@@@@@@@@@@@@@@@@@@@@@@@@@@@@@
@@@@@@@@@@@@@@@@@@@@@@@@@@@@@@@@@@@@@@@@@@@@@@@@@@@@
@@@@@@@@@@@@@@@@@@@@@@@@@@@@@@@@@@@@@@@@@@@@@@@@@@@@
@@@@@@@@@@@@@@@@@@@@@@@@@@@@@@@@.@@@@@@@@@@@@@@@@@@@
@@@@@@@@@@@@@@@@@@@@@@@@@@@@@@@...@@@@@@@@@@@@@@@@@@
@@@@@@@@@@@@@@@@@@@@@@@@@@@@@@....@@@@@@@@@@@@@@@@@@
@@@@@@@@@@@@@@@@@@@@@@@@@@@@@.....@@@@@@@@@@@@@@@@@@
@@@@@@@@@@@@@@@@@@@@@@@@@@@@@.....@@@@@@@@@@@@@@@@@@
@@@@@@@@@@@@@@@@@@@@@@@@@@@@.....@@@@@@@@@@@@@@@@@@@
@@@@@@@@@@@@@@@@@@@@@@@@@@@.....@@@@@@@@@@@@@@@@@@@@
@@@@@@@@@@@@@@@@@@@@@@@@@@@....@@@@@@@@@@@@@@@@@@@@@
@@@@@@@@@@@@@@@@@@@@@@@@@@...@@@@@@@@@@@@@@@@@@@@@@@
@@@@@@@@@@@@@@@@@@@@@@@.....@@@@@@@@@@@@@@@@@@@@@@@@
@@@@@@@@@@@@@@@@@@@@@@@.....@@@@@@@@@@@@@@@@@@@@@@@@
@@@@@@@@@@@@@@@@@@@@@@@....@@@@@@@@@@@@@@@@@@@@@@@@@
@@@@@@@@@@@@@@@@@@@@@@@....@@@@@@@@@@@@@@@@@@@@@@@@@
@@@@@@@@@@@@@@@@@@@@@@@....@@@@@@@@@@@@@@@@@@@@@@@@@
@@@@@@@@@@@@@@@@@@@@@@@....@@@@@@@@@@@@@@@@@@@@@@@@@
@@@@@@@@@@@@@@@@..@@@@@....@@@@@@@@@@@@@@@@@@@@@@@@@
@@@@@@@@@@@@@@@....@@@.....@@@@@@@@@@@@@@@@@@@@@@@@@
@@@@@@@@@@@@@@@.....@.......@@@@@@@@@@@@@@@@@@@@@@@@
@@@@@@@@@@@@@@..............@@@@@@@@@@@@@@@@@@@@@@@@
@@@@@@@@@@@@@.......................@@@@@@@@@@@@@@@@
@@@@@@@@@@@@@........................@@@@@@@@@@@@@@@
@@@@@@@@@@@@..............@@@@@.........@@@@@@@@@@@@
@@@@@@@@@@@@..............@@@@@@.........@@@@@@@@@@@
@@@@@@@@@@@@....@@............@@@.........@@@@@@@@@@
@@@@@@@@@@@....@@..............@@@.........@@@@@@@@@
@@@@@@@@@@.....@@................@@........@@@@@@@@@
@@@@@@@@......@@..................@@@.......@@@@@@@@
@@@@@@@@......@@...................@@.......@@@@@@@@
@@@@@@@.......@@....................@@........@@@@@@
@@@@@@@......@@......................@........@@@@@@
@@@@@@@......@@.........@@@@.........@........@@@@@@
@@@@@@@......@@........@@@@@@........@@.......@@@@@@
@@@@@@@......@@@.......@@@@@@........@@.......@@@@@@
@@@@@@@......@@@.......@@@@@@........@@........@@@@@
@@@@@@@......@@@........@@@@.........@@........@@@@@
@@@@@@@......@@@....................@@@.........@@@@
@@@@@@@.......@@@...................@@@.........@@@@
@@@@@@@.......@@@..................@@@@.........@@@@
@@@@@@@........@@..................@@@..........@@@@
@@@@@@@........@@@................@@@...........@@@@
@@@@@@@.........@@@..............@@@............@@@@
@@@@@@@..........@@@............@@@.............@@@@
@@@@@@@..........@@@@@........@@@@.............@@@@@
@@@@@@@...........@@@@@@@@@@@@@@@..............@@@@@
@@@@@@@.............@@@@@@@@@@@@...............@@@@@
@@@@@@@@......................................@@@@@@
@@@@@@@@@....................................@@@@@@@
@@@@@@@@@@..................................@@@@@@@@
@@@@@@@@@@@@.............................@@@@@@@@@@@
@@@@@@@@@@@@@@@........................@@@@@@@@@@@@@
@@@@@@@@@@@@@@@@...................@@@@@@@@@@@@@@@@@
@@@@@@@@@@@@@@@@@@@.............@@@@@@@@@@@@@@@@@@@@
@@@@@@@@@@@@@@@@@@@@@@@@@@@@@@@@@@@@@@@@@@@@@@@@@@@@
@@@@@@@@@@@@@@@@@@@@@@@@@@@@@@@@@@@@@@@@@@@@@@@@@@@@
@@@@@@@@@@@@@@@@@@@@@@@@@@@@@@@@@@@@@@@@@@@@@@@@@@@@
