type octile
height 75
width 72
map
@@@@@@@@@@@@@@@@@@@@@@@@@@@@@@@@@@@@@@@@@@@@@@@@@@@@@@@@@@@@@@@@@@@@@@@@
@@@@@@@@@@@@@@@@@@@@@@@@@@@@@@@@@@@@@@@@@@@@@@@@@@@@@@@@@@@@@@@@@@@@@@@@
@@@@@@@@@@@@@@@@@@@@@@@@@@@@@@@@@@@@@@@@@@@@@@@@@@@@@@@@@@@@@@@@@@@@@@@@
@@@@@@@@@@@@@@@@@@@@@@@@@@@@@@@@@@@@@@@@@@@@@@@@@@@@@@@@@@@@@@@@@@@@@@@@
@@@@@@@@@@@@@@@@@@@@@@@@@@@@@@@@@@@@@@@@@@@@@@@@@@@@@@@@@@@@@@@@@@@@@@@@
@@@@@@@@@@@@@@@@@@@@@@@@@@@@@@@@@@@@@@@@@@@@@@@@@@@@@@@@@@@@@@@@@@@@@@@@
@@@@@@@@@@@@@@@@@@@@@@@@@@@@@@@@@@@@@@@@@@@@@@@@@@@@@@@@@@@@@@@@@@@@@@@@
@@@@@@@@@@@@@@@@@@@@@@@@@@@@@@@@@@@@@@@@@@@@@@@@@@@@@@@@@@@@@@@@@@@@@@@@
@@@@@@@@@@@@@@@@@@@@@@@@@@@@@@@@@@@@@@@@@@@@@@@@@@@@@@@@@@@@@@@@@@@@@@@@
@@@@@@@@@@@@@@@@@@@@@@@@@@@@@@@@@@@@@@@@@@@@@@@@@@@@@@@@@@@@@@@@@@@@@@@@
@@@@@@@@@@@@@@@@@@@@@@@@@@@@@@@@@@@@@@@@@@@@@@@@@@@@@@@@@@@@@@@@@@@@@@@@
@@@@@@@@@@@@@@@@@@@@@@@@@@@@@@@@@@@@@@@@@@@@@@@@@@@@@@@@@@@@@@@@@@@@@@@@
@@@@@@@@@@@@@@@@@@@@@@@@@@@@@@@@@@@@@@@@@.@@@@@@@@@@@@@@@@@@@@@@@@@@@@@@
@@@@@@@@@@@@@@@@@@@@@@@@@@@@@@@@@@@@@@@@@.@@@@@@@@@@@@@@@@@@@@@@@@@@@@@@
@@@@@@@@@@@@@@@@@@@@@@@@@@@@@@@@@@@@@@@@@..@@@@@@...@@@@@@@@@@@@@@@@@@@@
@@@@@@@@@@@@@@@@@@@@@@@@@@@@@@@@@@@@@@@@.....@@@@...@@@@@@@@@@@@@@@@@@@@
@@@@@@@@@@@@@@@@@@@@@@@@@@@@@@@@@..@@@@............@@@@@@@@@@@@@@@@@@@@@
@@@@@@@@@@@@@@@@@@@@@@@@@@@@@@@@@...@@@...........@@@@@@@@@@@@@@@@@@@@@@
@@@@@@@@@@@@@@@@@@@@@@@@@@@@@@@@@...@@............@@@@@@@@@@@@@@@@@@@@@@
@@@@@@@@@@@@@@@@@@@@@@@@@@@@@@@@@@...@..............@@@@@@@@@@@@@@@@@@@@
@@@@@@@@@@@@@@@@@@@@@@@@@@@@@@@@@@...@@..............@@@@@@@@@@@@@@@@@@@
@@@@@@@@@@@@@@@@@@@@@@@@@@@@@@@@@@@...@@..............@@@@@@@@@@@@@@@@@@
@@@@@@@@@@@@@@@@@@@@@@@@@@@@@.@@@@@...@@@.............@@@@..@@@@@@@@@@@@
@@@@@@@@@@@@@@@@@@@@@@@@@@@....@@@@@...@@@............@@.....@@@.@@@@@@@
@@@@@@@@@@@@@@@@@@@@@@@@@@.......@@@...@@@@....................@..@@@@@@
@@@@@@@@@@@@@@@@@@@@@@@@@.........@@@....@@@@@.....................@@@@@
@@@@@@@@@@@@@@@@@@@@@@@@.....@@@@..@@.....@@@.......................@@@@
@@@@@@@@@@@@@@@@@@@@@@@@...@@@@@@@...................................@@@
@@@@@@@@@@@@@@@@@@@@@@@....@@@@@@@.............@@@...................@@@
@@@@@@@@@@@@@@@@@@@@@@.......@@@@........@@.....@@@@................@@@@
@@@@@@@@@@@@@@@@@@@@@...@@@..@@@@.......@@@@.....@@@@@@............@@@@@
@@@@@@@@@@@@@@@@@@@@@..@@@@....@@.......@@@@@@.....@@@@@@.........@@@@@@
@@@@@@@@@@@@@@@@@@@@@..@@@@@............@@@@@@.......@@@@@@.......@@@@@@
@@@@@@@@@@@@@@@@@@@@....@@@@............@@@@@...........@@@@.....@@@@@@@
@@@@@@@@@@@@@@@@@@@@....@@@@............@@@@..............@@@@@@@@@@@@@@
@@@@@@@@@@@@@@@@@@@....@@@@...@@@@@@....@@..................@@@@@@@@@@@@
@@@@@@@@@@@@@@@@@@....@@@@@...@@@@@@.........................@@@@@@@@@@@
@@@@@@@@@@@@@@@@....@@@@@@@...@@@@@.........................@@@@@@@@@@@@
@@@@@@@@@@@@@@...@@@@@@@@@....@@@@@..........@@@@@.........@@@@@@@@@@@@@
@@@@@@@@@@@@@@...@@@@@@@.....@@@@@@.........@@@@@@........@@@@@@@@@@@@@@
@@@@@@@@@@@@@@@...@@@@@@.....@@@...........@@@@@@........@@@@@@@@@@@@@@@
@@@@@@@@@@@@@@@............................@@@@@@.......@@@@@@@@@@@@@@@@
@@@@@@@@@@@@@@.............................@@@@@@.......@@@@@@@@@@@@@@@@
@@@@@@@@@@@@...@@@@.......................@@@@@@.......@@@@@@@@@@@@@@@@@
@@@@@@@@@@@...@@@@@........................@@@@.......@@@@@@@@@@@@@@@@@@
@@@@@@@@@@....@@@@@..........................@@......@@@@@@@@@@@@@@@@@@@
@@@@@@@@@.....@@@@@......@@@@.......................@@@@@@@@@@@@@@@@@@@@
@@@@@@@@.......@@.......@@@@@@........@@.............@@@@@@@@@@@@@@@@@@@
@@@@@@@.................@@@@@@@@......@@@.............@@@@@@@@@@@@@@@@@@
@@@@@@@@@................@@@@@@@.......@@@.............@@@@@@@@@@@@@@@@@
@@@@@@@@@@@..............@@@@@...........@............@@@@@@@@@@@@@@@@@@
@@@@@@@@@@@@.............@@...........................@@@@@@@@@@@@@@@@@@
@@@@@@@@@@@@@@.......................................@@@@@@@@@@@@@@@@@@@
@@@@@@@@@@@@@@@@................@@@@................@@@@@@@@@@@@@@@@@@@@
@@@@@@@@@@@@@@@@@@@............@@@@@...............@@@@@@@@@@@@@@@@@@@@@
@@@@@@@@@.....@@@@@...........@@@@@@..........@...@@@@@@@@@@@@@@@@@@@@@@
@@@@@@@@@.......@@@...........@@@@@@.........@@@.@@@@@@@@@@@@@@@@@@@@@@@
@@@@@@@@............@@@.......@@@@@@........@@@@@@@@@@@@@@@@@@@@@@@@@@@@
@@@@@@@.............@@@@@.......@@@........@@@@@@@@@@@@@@@@@@@@@@@@@@@@@
@@@@@@@...@@.......@@@@@@@@.....@@........@@@@@@@@@@@@@@@@@@@@@@@@@@@@@@
@@@@@@@..@@@@......@@@@@@@@@.............@@@@@@@@@@@@@@@@@@@@@@@@@@@@@@@
@@@@@@...@@@@......@@@@@@@@@@@..........@@@@@@@@@@@@@@@@@@@@@@@@@@@@@@@@
@@@@@@..@@@@.......@@@@..@@@@@@@........@@@@@@@@@@@@@@@@@@@@@@@@@@@@@@@@
@@@@@@@@@@@@...............@@@@@@......@@@@@@@@@@@@@@@@@@@@@@@@@@@@@@@@@
@@@@@@@@@@................@@@@@@@@....@@@@@@@@@@@@@@@@@@@@@@@@@@@@@@@@@@
@@@@@@@@@.................@@@@@@@@@@.@@@@@@@@@@@@@@@@@@@@@@@@@@@@@@@@@@@
@@@@@@@@.................@@@@@@@@@@@@@@@@@@@@@@@@@@@@@@@@@@@@@@@@@@@@@@@
@@@@@@@@................@@@@@@@@@@@@@@@@@@@@@@@@@@@@@@@@@@@@@@@@@@@@@@@@
@@@@@@@@@..............@@@@@@@@@@@@@@@@@@@@@@@@@@@@@@@@@@@@@@@@@@@@@@@@@
@@@@@@@@@@............@@@@@@@@@@@@@@@@@@@@@@@@@@@@@@@@@@@@@@@@@@@@@@@@@@
@@@@@@@@@@@..........@@@@@@@@@@@@@@@@@@@@@@@@@@@@@@@@@@@@@@@@@@@@@@@@@@@
@@@@@@@@@@@@@.......@@@@@@@@@@@@@@@@@@@@@@@@@@@@@@@@@@@@@@@@@@@@@@@@@@@@
@@@@@@@@@@@@@@@@...@@@@@@@@@@@@@@@@@@@@@@@@@@@@@@@@@@@@@@@@@@@@@@@@@@@@@
@@@@@@@@@@@@@@@@@@@@@@@@@@@@@@@@@@@@@@@@@@@@@@@@@@@@@@@@@@@@@@@@@@@@@@@@
@@@@@@@@@@@@@@@@@@@@@@@@@@@@@@@@@@@@@@@@@@@@@@@@@@@@@@@@@@@@@@@@@@@@@@@@
