type octile
height 64
width 60
map
@@@@@@@@@@@@@@@@@@@@@@@@@@@@@@@@@@@@@@@@@@@@@@@@@@@@@@@@@@@@
@@@@@@@@@@@@@@@@@@@@@@@@@@@@@@@@@@@@@@@@@@@@@@@@@@@@@@@@@@@@
@@@@@@@@@@@@@@@@@@@@@@@@@@@@@@@@@@@@@@@@@@@@@@@@@@@@@@@@@@@@
@@@@@@@@@@@@@@@@@@@@@@@@@@@@@@@@@@@@@@@@@@@@@@@@@@@@@@@@@@@@
@@@@@@@@@@@@@@@@@@@@@@@@@@@@@@@@@@@@@@@@@@@@@@@@@@@@@@@@@@@@
@@@@@@@@@@@@@@@@@@@@@@@@@@@@@@@@@@@@@@@@@@@@@@@@@@@@@@@@@@@@
@@@@@@@@@@@@@@@@@@@@@@@@@@@@@@@@@@@@@@@@@@@@@@@@@@@@@@@@@@@@
@@@@@@@@@@@@@@@@@@@@@@@@@@@@@@@@@@@@@@@@@@@@@@@@@@@@@@@@@@@@
@@@@@@@@@@@@@@@@@@@@@@@@@@@@@@@@@@@@@@@@@@@@@@@@@@@@@@@@@@@@
@@@@@@@@@@@@@@@@@@@@@@@@@@@@@@@@@@@@@@@@@@@@@@@@@@@@@@@@@@@@
@@@@@@@@@@@@@@@@@@@@@@@@@@@@@@@@@@@@@@@@@@@@@@@@@@@@@@@@@@@@
@@@@@@@@@@@@@@@@@@@@@@@@@@@@@@@@@@@@@@@@@@@@@@@@@@@@@@@@@@@@
@@@@@@@@@@@@@@@@@@@@@@@@@@@@@@@@@@@@@@@@@@@@@@@@@@@@@@@@@@@@
@@@@@@@@@@@@@@@@@@@@@@@@@@@....@@@@@@@@@@@@@@@@@@@@@@@@@@@@@
@@@@@@@@@@@@@@@@@@@@@@@@@@........@@@@@@@@@@@@@@@@@@@@@@@@@@
@@@@@@@@@@@@@@@@@@@@@@@@@@.........@@@@@@@@@@@@@@@@@@@@@@@@@
@@@@@@@@@@@@@@@@@@@@@@@@@@...........@@@@@@@@@@@@@@@@@@@@@@@
@@@@@@@@@@@@@@@@@@@@@@@@@@.............@@@@@@@@@@@@@@@@@@@@@
@@@@@@@@@@@@@@@@@@@@@@@@@@..............@@@@@@@@@@@@@@@@@@@@
@@@@@@@@@@@@@@@@@@@@@@@@@@...............@@@@@@@@@@@@@@@@@@@
@@@@@@@@@@@@@@@@@@@@@@@@@@...............@@@.@@@@@@@@@@@@@@@
@@@@@@@@@@@@@@@@@@@@@@@@@.....................@@@@@@@@@@@@@@
@@@@@@@@@@@@@@@@@@@@@@@@@.....................@@@@@@@@@@@@@@
@@@@@@@@@@@@@@@.....@@@@@.................@....@@@@@@@@@@@@@
@@@@@@@@@@@@@@.......@@@............@@@...@@...@@@@@@@@@@@@@
@@@@@@@@@@@@@@@............@@@@....@@@@...@@...@@@@@@@@@@@@@
@@@@@@@@@@@@@@@............@@@@..@@@@@@..@@@...@@@@@@@@@@@@@
@@@@@@@@@@@@@@@............@@@@@@@@@@@...@@@...@@@@@@@@@@@@@
@@@@@@@@@@@@@@@.......@@@@@@@@@@@@@@@@@@@@@....@@@@@@@@@@@@@
@@@@@@@@@@@@@@@.......@@@@@@@@@@@@@@@@@@@@.....@@@@@@@@@@@@@
@@@@@@@@@@@@@.........@@@@@@@@@@@@@@@@@@@@...@@@@....@@@@@@@
@@@@@@@@@@@@@........@@@@@@@@@@@@@@@@@@@@@...@@@......@@@@@@
@@@@@@@@@@@@@.........@@@@@@@@@@@@@@@@@@@@@...@@......@@@@@@
@@@@@@@@@@@@@..........@@@@@@@@@@@@@@@@...@@..@@......@@@@@@
@@@@@@@@@@@@@.........@@@@@@@@@@@@@@@@@...@@..........@@@@@@
@@@@@@@@@@@@@@.......@@@@@@@.@@@@@@@@@@...@@@.........@@@@@@
@@@@@@@@@@@@@@@.....@@@@@@@...@@@@@@@@@...............@@@@@@
@@@@@@@@@@@@@@@@....@@@@@@@....@@@@@@@@...............@@@@@@
@@@@@@@@@@@@@@@@@..@@@@@@@......@@@@@@................@@@@@@
@@@@@@@@@@@@@@@@@@@@@@@@@@..@@@..@@...................@@@@@@
@@@@@@@@@@@@@@@@@@@@@@@@@..@@@@@.@@...................@@@@@@
@@@@@@@@@@@@@@@@@@@@@@@@@..@@@@@......................@@@@@@
@@@@@@@@@@@@@@@@@@@@@@@@...@@@@......................@@@@@@@
@@@@@@@@@@@@@@@@@@@@@@@@...@@@@.....................@@@@@@@@
@@@@@@@@....@...@@@@@@@@............................@@@@@@@@
@@@@@@@@.........@@@@@@@@..........................@@@@@@@@@
@@@@@@@@............@@@@..........................@@@@@@@@@@
@@@@@@@@............@@............................@@@@@@@@@@
@@@@@@@@@........................................@@@@@@@@@@@
@@@@@@@@@@.......................................@@@@@@@@@@@
@@@@@@@@@@@.....................................@@@@@@@@@@@@
@@@@@@@@@@@@...................................@@@@@@@@@@@@@
@@@@@@@@@@@@@..................................@@@@@@@@@@@@@
@@@@@@@@@@@@@@................................@@@@@@@@@@@@@@
@@@@@@@@@@@@@@@..............................@@@@@@@@@@@@@@@
@@@@@@@@@@@@@@@@@............................@@@@@@@@@@@@@@@
@@@@@@@@@@@@@@@@@@@.........................@@@@@@@@@@@@@@@@
@@@@@@@@@@@@@@@@@@@@@.......................@@@@@@@@@@@@@@@@
@@@@@@@@@@@@@@@@@@@@@@@@...................@@@@@@@@@@@@@@@@@
@@@@@@@@@@@@@@@@@@@@@@@@@@................@@@@@@@@@@@@@@@@@@
@@@@@@@@@@@@@@@@@@@@@@@@@@@@@@...........@@@@@@@@@@@@@@@@@@@
@@@@@@@@@@@@@@@@@@@@@@@@@@@@@@@@@........@@@@@@@@@@@@@@@@@@@
@@@@@@@@@@@@@@@@@@@@@@@@@@@@@@@@@@@@@@@@@@@@@@@@@@@@@@@@@@@@
@@@@@@@@@@@@@@@@@@@@@@@@@@@@@@@@@@@@@@@@@@@@@@@@@@@@@@@@@@@@
