type octile
height 86
width 80
map
@@@@@@@@@@@@@@@@@@@@@@@@@@@@@@@@@@@@@@@@@@@@@@@@@@@@@@@@@@@@@@@@@@@@@@@@@@@@@@@@
@@@@@@@@@@@@@@@@@@@@@@@@@@@@@@@@@@@@@@@@@@@@@@@@@@@@@@@@@@@@@@@@@@@@@@@@@@@@@@@@
@@@@@@@@@@@@@@@@@@@@@@@@@@@@@@@@@@@@@@@@@@@@@@@@@@@@@@@@@@@@@@@@@@@@@@@@@@@@@@@@
@@@@@@@@@@@@@@@@@@@@@@@@@@@@@@@@@@@@@@@@@@@@@@@@@@@@@@@@@@@@@@@@@@@@@@@@@@@@@@@@
@@@@@@@@@@@@@@@@@@@@@@@@@@@@@@@@@@@@@@@@@@@@@@@@@@@@@@@@@@@@@@@@@@@@@@@@@@@@@@@@
@@@@@@@@@@@@@@@@@@@@@@@@@@@@@@@@@@@@@@@@@@@@@@@@@@@@@@@@@@@@@@@@@@@@@@@@@@@@@@@@
@@@@@@@@@@@@@@@@@@@@@@@@@@@@@@@@@@@@@@@@@@@@@@@@@@@@@@@@@@@@@@@@@@@@@@@@@@@@@@@@
@@@@@@@@@@@@@@@@@@@@@@@@@@@@@@@@@@@@@@@@@@@@@@@@@@@@@@@@@@@@@@@@@@@@@@@@@@@@@@@@
@@@@@@@@@@@@@@@@@@@@@@@@@@@@@@@@@@@@@@@@@@@@@@@@@@@@@@@@@@@@@@@@@@@@@@@@@@@@@@@@
@@@@@@@@@@@@@@@@@@@@@@@@@@@@@@@@@@@@@@@@@@@@@@@@@@@@@@@@@@@@@@@@@@@@@@@@@@@@@@@@
@@@@@@@@@@@@@@@@@@@@@@@@@@@@@@@@@@@@@@@@@@@@@@@@@@@@@@@@@@@@@@@@@@@@@@@@@@@@@@@@
@@@@@@@@@@@@@@@@@@@@@@@@@@@@@@@@@@@@@@@@@@@@@@@@@@@@@@@@@@@@@@@@@@@@@@@@@@@@@@@@
@@@@@@@@@@@@@@@@@@@@@@@@@@@@@@@@@@@@@@@@@@@@@@@@@@@@@@@@@@@@@@@@@@@@@@@@@@@@@@@@
@@@@@@@@@@@@@@@@@@@@@@@@@@@@@@@@@@@@@@@@@@@@@@@@@@@@@@@@@@@@@@@@@@@@@@@@@@@@@@@@
@@@@@@@@@@@@@@@@@@@@@@@@@@@@@@@@@@@@@@@@@@@@@@@@@@@@@@@@@@@@@@@@@@@@@@@@@@@@@@@@
@@@@@@@@@@@@@@@@@@@@@@@@@@@@@@@@@@@@@@@@@@@@@@@@@@@@@@@@@@@@.@@@@@@@@@@@@@@@@@@@
@@@@@@@@@@@@@@@@@@@@@@@@@@@@@@@@@@@@@@@@@@@@@@@@@@@@@@@@@@@@..@@@@@@@@@@@@@@@@@@
@@@@@@@@@@@@@@@@@@@@@@@@@@@@@@@@@@@@@@@@@@@@@@@@@@@@@@@@@@@...@@@@@@@@@@@@@@@@@@
@@@@@@@@@@@@@@@@@@@@@@@@@@@@@@@@@@@@@@..@@@@@@@@@@@@@@@@@@...@@@@@@@@@@@@@@@@@@@
@@@@@@@@@@@@@@@@@@@@@@@@@@@@@@@@@@@...................@@@....@@@@@@@@@@@@@@@@@@@
@@@@@@@@@@@@@@@@@@@@@@@@@@@@@@@@@@......................@...@@@@@@@@@@@@@@@@@@@@
@@@@@@@@@@@@@@@@@@@@@@@@@@......@@.....................@@...@@@@@@@@@@@@@@@@@@@@
@@@@@@@@@@@@@@@@@@@@@@@@...............................@....@@.@@@@@@@@@@@@@@@@@
@@@@@@@@@@@@@@@@@@@@@@.................................@....@..@@@@@@@@@@@@@@@@@
@@@@@@@@@@@@@@@@@@@@@.................................@@...@@..@@@@@@@@@@@@@@@@@
@@@@@@@@@@@@@@@@@.@@@.................................@....@@..@@@@@@@@@@@@@@@@@
@@@@@@@@@@@@@@.@@..@@.................................@....@@...@@@@@@@@@@@@@@@@
@@@@@@@@@@@@@@.......................................@@...@@@....@@@@@@@@@@@@@@@
@@@@@@@@@@@@@........................................@....@@@.....@@@@@@@@@@@@@@
@@@@@@@@@@@@@......................................@@@....@@.......@@@@@@@@@@@@@
@@@@@@@@@@@@.......................................@@@...@@@........@@@@@@@@@@@@
@@@@@@@@@@@@......................................@@@....@@..........@@@@@@@@@@@
@@@@@@@@@@@..............................................@@...........@@@@@@@@@@
@@@@@@@@@@..............................................@@@............@@@@@@@@@
@@@@@@@@@..............................................@@@@@...........@@@@@@@@@
@@@@@@@@@..............................................................@@@@@@@@@
@@@@@@@@@..............................................................@@@@@@@@@
@@@@@@@@@@..............................................................@@@@@@@@
@@@@@.@@@@..............................................................@@@@@@@@
@@@@@....................................................................@@@@@@@
@@@@@....................................................................@@@@@@@
@@@@@.....................................................................@@@@@@
@@@@@...............................@@@@@@@................................@@@@@
@@@@@.............................@@@@@@@@@@...............................@@@@@
@@@@@.............................@@@@@@@@@@................................@@@@
@@@@@............................@@@@@..@@@@....@@...........................@@@
@@@@@............................@@@....@@@....@@@...........................@@@
@@@@@.........................................@@@@...........................@@@
@@@@@........................@@..............@@@@@@..........................@@@
@@@@@.....................@@.@@@.............@@@@@@..........................@@@
@@@@@.....................@@@@@@@............@@@@@@..........................@@@
@@@@@.......................@@@@@.............@@@@@@.........................@@@
@@@@@.......................@@@@@...............@@@@.........................@@@
@@@@@.......................@@@@.................@@@.........................@@@
@@@@@.......................@@@@................@@@@.........................@@@
@@@@@.......................@@@................@@@@@.........................@@@
@@@@@.......................@@@...............@@@@@..........................@@@
@@@@@.......................@@@@@..............@@@@..........................@@@
@@@@@........................@@@@...............@@@..........................@@@
@@@@@........................@@@@@@..........................................@@@
@@@@@.........................@@@@............@..............................@@@
@@@@@.......................................@@@..............................@@@
@@@@@.................................@@@@@@@@@@@............................@@@
@@@@@................................@@@@@@@@@@@@............................@@@
@@@@@..............................@@@@@@@@@@@...............................@@@
@@@@@..............................@@@@@@@@@@................................@@@
@@@@@........................................................................@@@
@@@@@........................................................................@@@
@@@@@........................................................................@@@
@@@@@.......................................................................@@@@
@@@@@.......................................................................@@@@
@@@@@@.....................................................................@@@@@
@@@@@@.....................................................................@@@@@
@@@@@@@...................................................................@@@@@@
@@@@@@@@................................................................@@@@@@@@
@@@@@@@@@..............................................................@@@@@@@@@
@@@@@@@@@@@..........................................................@@@@@@@@@@@
@@@@@@@@@@@@@@.....................................................@@@@@@@@@@@@@
@@@@@@@@@@@@@@@@.................................................@@@@@@@@@@@@@@@
@@@@@@@@@@@@@@@@@@@............................................@@@@@@@@@@@@@@@@@
@@@@@@@@@@@@@@@@@@@@@.......................................@@@@@@@@@@@@@@@@@@@@
@@@@@@@@@@@@@@@@@@@@@@@@..................................@@@@@@@@@@@@@@@@@@@@@@
@@@@@@@@@@@@@@@@@@@@@@@@@@..............................@@@@@@@@@@@@@@@@@@@@@@@@
@@@@@@@@@@@@@@@@@@@@@@@@@@@@..........................@@@@@@@@@@@@@@@@@@@@@@@@@@
@@@@@@@@@@@@@@@@@@@@@@@@@@@@@@@@@@@@@@@@@@@@@@@@@@@@@@@@@@@@@@@@@@@@@@@@@@@@@@@@
@@@@@@@@@@@@@@@@@@@@@@@@@@@@@@@@@@@@@@@@@@@@@@@@@@@@@@@@@@@@@@@@@@@@@@@@@@@@@@@@
