type octile
height 54
width 60
map
@@@@@@@@@@@@@@@@@@@@@@@@@@@@@@@@@@@@@@@@@@@@@@@@@@@@@@@@@@@@
@@@@@@@@@@@@@@@@@@@@@@@@@@@@@@@@@@@@@@@@@@@@@@@@@@@@@@@@@@@@
@@@@@@@@@@@@@@@@@@@@@@@@@@@@@@@@@@@@@@@@@@@@@@@@@@@@@@@@@@@@
@@@@@@@@@@@@@@@@@@@@@@@@@@@@@@@@@@@@@@@@@@@@@@@@@@@@@@@@@@@@
@@@@@@@@@@@@@@@@@@@@@@@@@@@@@@@@@@@@@@@@@@@@@@@@@@@@@@@@@@@@
@@@@@@@@@@@@@@@@@@@@@@@@@@@@@@@@@@@@@@@@@@@@@@@@@@@@@@@@@@@@
@@@@@@@@@@@@@@@@@@@@@@@@@@@@@@@@@@@@@@@@@@@@@@@@@@@@@@@@@@@@
@@@@@@@@@@@@@@@@@@@@@@@@@@@@@@@@@@@@@@@@@@@@@@@@@@@@@@@@@@@@
@@@@@@@@@@@@@@@@@@@@@@@@@@@@@@@@@@@@@@@@@@@@@@@@@@@@@@@@@@@@
@@@@@@@@@@@@@@@@@@@@@@.................@@@@@@@@@@@@@@@@@@@@@
@@@@@@@@@@@@@@@@@@@.......................@@@@@@@@@@@@@@@@@@
@@@@@@@@@@@@@@@@@...........................@@@@@@@@@@@@@@@@
@@@@@@@@@@@@@@@...............................@@@@@@@@@@@@@@
@@@@@@@@@@@@@..................................@@@@@@@@@@@@@
@@@@@@@@@@@@....................................@@@@@@@@@@@@
@@@@@@@@@@@...............@@@@...................@@@@@@@@@@@
@@@@@@@@@@......@@........@@@@@@@.................@@@@@@@@@@
@@@@@@@@@......@@@....@......@@@@..................@@@@@@@@@
@@@@@@@@......@@@.....@.............................@@@@@@@@
@@@@@@@......@@@..................@@.....@...........@@@@@@@
@@@@@@......@@@..................@@@@....@...........@@@@@@@
@@@@@@.......@.....................@@@@...............@@@@@@
@@@@@...............................@@@@.........@....@@@@@@
@@@@@................................@..........@@@....@@@@@
@@@@.....................................@.......@@@....@@@@
@@@@......................@@............@@@@@.....@@@.@.@@@@
@@@@.....................@@@@@@........@@@@@@@.....@@@@.@@@@
@@@@......................@@@@@@...........@@......@@@@@@@@@
@@@@........................@@......................@@@@@@@@
@@@@.......@@.......................................@@@@@@@@
@@@@........@........................................@@@@@@@
@@@@..................@@@.............................@@@@@@
@@@@.@@.........@@...@@@@@.....@........................@@@@
@@@@@@@@.......@@@@....@@@@@..@@........................@@@@
@@@@@@@@@......@@@@......@@@....................@.......@@@@
@@@@.@@@......@@@@@.......@.....................@@......@@@@
@@@@..@@........@.@@....................................@@@@
@@@@..................................@@................@@@@
@@@@.................................@@@.........@@.....@@@@
@@@@.................................@@@@.......@@@@....@@@@
@@@@@...............................@@@@........@@@@....@@@@
@@@@@..................................@.......@@@@@....@@@@
@@@@@@.....@@....................................@@@@...@@@@
@@@@@@....@@@@..........................................@@@@
@@@@@@@..@@@@@@........................................@@@@@
@@@@@@@....@@@@.......................................@@@@@@
@@@@@@@@....@@..............................@@@@......@@@@@@
@@@@@@@@....................................@@@@.....@@@@@@@
@@@@@@@@@.........@........................@@@@@....@@@@@@@@
@@@@@@@@@.........@@.............@@................@@@@@@@@@
@@@@@@@@@@......................@@@@..............@@@@@@@@@@
@@@@@@@@@@@@....................@@@@....@@.......@@@@@@@@@@@
@@@@@@@@@@@@@@..................@@@@@..........@@@@@@@@@@@@@
@@@@@@@@@@@@@@@@@@@@@@@@@@@@@@@@@@@@@@@@@@@@@@@@@@@@@@@@@@@@
