type octile
height 86
width 100
map
@@@@@@@@@@@@@@@@@@@@@@@@@@@@@@@@@@@@@@@@@@@@@@@@@@@@@@@@@@@@@@@@@@@@@@@@@@@@@@@@@@@@@@@@@@@@@@@@@@@@
@@@@@@@@@@@@@@@@@@@@@@@@@@@@@@@@@@@@@@@@@@@@@@@@@@@@@@@@@@@@@@@@@@@@@@@@@@@@@@@@@@@@@@@@@@@@@@@@@@@@
@@@@@@@@@@@@@@@@@@@@@@@@@@@@@@@@@@@@@@@@@@@@@@@@@@@@@@@@@@@@@@@@@@@@@@@@@@@@@@@@@@@@@@@@@@@@@@@@@@@@
@@@@@@@@@@@@@@@@@@@@@@@@@@@@@@@@@@@@@@@@@@@@@@@@@@@@@@@@@@@@@@@@@@@@@@@@@@@@@@@@@@@@@@@@@@@@@@@@@@@@
@@@@@@@@@@@@@@@@@@@@@@@@@@@@@@@@@@@@@@@@@@@@@@@@@@@@@@@@@@@@@@@@@@@@@@@@@@@@@@@@@@@@@@@@@@@@@@@@@@@@
@@@@@@@@@@@@@@@@@@@@@@@@@@@@@@@@@@@@@@@@@@@@@@@@@@@@@@@@@@@@@@@@@@@@@@@@@@@@@@@@@@@@@@@@@@@@@@@@@@@@
@@@@@@@@@@@@@@@@@@@@@@@@@@@@@@@@@@@@@@@@@@@@@@@@@@@@@@@@@@@@@@@@@@@@@@@@@@@@@@@@@@@@@@@@@@@@@@@@@@@@
@@@@@@@@@@@@@@@@@@@@@@@@@@@@@@@@@@@@@@@@@@@@@@@@@@@@@@@@@@@@@@@@@@@@@@@@@@@@@@@@@@@@@@@@@@@@@@@@@@@@
@@@@@@@@@@@@@@@@@@@@@@@@@@@@@@@@@@@@@@@@@@@@@@@@...@@@@@@@@@@@@@@@@@@@@@@@@@@@@@@@@@@@@@@@@@@@@@@@@@
@@@@@@@@@@@@@@@@@@@@@@@@@@@@@@@@@@@@@@@@@@@@@@@@...@....@@@@@@@@@@@@@@@@@@@@.....@@@@@@@@@@@@@@@@@@@
@@@@@@@@@@@@@@@@@@@@@@@@@@@@@@@@@@@@@@@@@@@@@@@@...@......@@@@@@@@@@@@@@@@@.......@@@@@@@@@@@@@@@@@@
@@@@@@@@@@@@@@@@@@@@@@@@@@@@@@@@@@@@@@@..@@@@@@@...@@@@@..@@@@@@@@@@@@@@@@........@@@@@@@@@@@@@@@@@@
@@@@@@@@@@@@@@@@@@@@@@@@@@@@@@@@@@@@@...@@@@@@@@...@@@@@.....@@@@@@@@@@@@..@@....@@@@@@@@@@@@@@@@@@@
@@@@@@@@@@@@@@@@@@@@@@@@@@@@@@@@@@@@....@@@@@@@@...@.........@@@@@@@@@@@...@@@....@@@@@@@@@@@@@@@@@@
@@@@@@@@@@@@@@@@@@@@@@@@@@@@@@@....................@@........@@@@@@@@@@..@..@@@....@@@@@@@@@@@@@@@@@
@@@@@@@@@@@@@@@@@@@@@@@@@@@@@@@.....................@@@@......@@@@@@@@@..@@..@@@....@@@.@@@@@@@@@@@@
@@@@@@@@@@@@@@@@@@@@@@@@@@@@@@@............@@@@@...............@@@@@@@@@..@@..............@@@@@@@@@@
@@@@@@@@@@@@@@@@@@@@@@@@@@@@@@@............@@@@@................@@@@@@@@@..@@@...@@.......@@@@@@@@@@
@@@@@@@@@@@@@@@@@@@@@@@@@@@@@@@............@@@@@.................@@@@@@@@@.......@@@......@@@@@@@@@@
@@@@@@@@@@@@@@@@@@@@@@@@@@@@@@@.......@@@@@@@@@@.............@....@@@@@@@@@@...@..@@@....@@@@@@@@@@@
@@@@@@@@@@@@@@@@@@@@@@@@@@@@@@@....@@@@@@@@@@@@@.............@@....@@@@@@@.....@@..@@...@@@@@@@@@@@@
@@@@@@@@@@@@@@@@@@@@@@@@@@@@@@@@@@@@@@@@@@@@@@@@.............@@@....@@@@@@......@@.....@@@@@@@@@@@@@
@@@@@@@@@@@@@@@@@@@@@@@@@@@@@@@@@@@@@@@@@@@@@@@@@@@@@@@@@@@@@@@@@....@@@@@.......@@...@@@@@@@@@@@@@@
@@@@@@@@@@@@@@@@@@@@@@@@@@@@@@@@@@@@@@@@@@@@@@@@@@@@@@@@@@@@@@@@@@....@@@@...@.......@@@@@@@@@@@@@@@
@@@@@@@@@@@@.@@.@@@@@@@@@@@@@@@@@@@@@@@@@@@@@@@@@@@@@@@@@@@@@@@@@@@....@@...@@@....@@@@@@@@@@@@@@@@@
@@@@@..@@@@........@@@@@@@@@@@@@@@@@@@@@@@@@@@@@@@@@@@@@@@@@@@@@@@@@.......@@@@@@.@@@@@@@@@@@@@@@@@@
@@@@@................@@@@@@@@@@@@@@@@@@@@@@@@@@@@@@@@@@@@@@@@@@@@@@@@......@@@@@@@@@@@@@@@@@@@@@@@@@
@@@@...........@@.....@@@@@@@@@@@@@@@@@@@@@@@@@@@@@@@@@@@@@@@@@@@@@@@@.....@@@@@@@@@@@@@@@@@.@@@@@@@
@@@@....@@@....@@@....@@@@@@@@@@@@@@@@@@@@@@@@@@@@@@@@@@@@@@@@@@@@@@@@@.....@@@@@@@@@@@@@@....@@@@@@
@@@...........@@@@...@@@@@@@@@@@@@@@@@@@@@@@@@@@@@@@@@@@@@@@@@@@@@@@@@@@.....@@@@@@@@@@@.....@@@@@@@
@@@...........@@@....@@@@@@@@@@@@@@@@@@@@.....@@@@@@@@@.@@@@@@@@@@@@@@@@@.....@@@@@@@@.....@@@@@@@@@
@@...........@@@@....@@@@@@@@@@@@@@@@@@.........@@@@@@@..@@@@@@@@@@@@@@@@@.....@@@@@.....@@@@@@@@@@@
@@@..........@@@@...@@@@@@@@@@@@@@@@@..............@@@@@...@@@@@@@@@@@@@@@@.....@@@....@@@@@@@@@@@@@
@@@@@.........@@....@@@@@@@@@@@@@@@...@@@..........@@@@@....@@@@@@@@@@@@@@@@..........@@@@@@@@@@@@@@
@@@@@@@@...........@@@@@@@@@@@@@@@....@@@@@@@......@@@@@.....@@@@@@@@@@@@@@@@.......@@@@@@@@@@@@@@@@
@@@@@@@@...@@@@@...@@@@@@@@@@@@@@.........@@@@....@@@@@@......@@@@@@@@@@@@@@@@@.....@@@@@@@@@@@@@@@@
@@@@@@@@..@@@@@@@@@@@@@@@@@@@@@@@............@@@..@@@@@........@@@@@@@@@@@@@@@@.....@@@@@@@@@@@@@@@@
@@@@@@....@@@@@@@@@@@@@@@@@@@@@@@@..@@.........@..@@@@@.........@@@@@@@@@@@@@@@.....@@@@@@@@@@@@@@@@
@@@@@@....@@@@@@@@@@@@@@@@@@@@@@@@..@@@@@........@@@@@...........@@.@@@@@@@@@@@.....@@@@@@@@@@@@@@@@
@@@@@@.....@@@@@@@@@@@@@@@@@@@@@@.....@@@@@@.....@@@@@..@@@@@.......@@@@@@@@@@@....@@@@@@@@@@@@@..@@
@@@@@@.....@@@@@@@@@@@@@@@@@@@@@@..@@....@@@@@..@@.....@@@@@@@..@@...@@@@@@@@@@....@@@@@@@@@@@@....@
@@@@@@.....@@@@@@@@@@@@@@@@@@@@@...@@@@@....@@..@.........@@...@@@@..@@@@@@@@@@@@..@@@@@@@@@@@@....@
@@@@@@.....@@@@@@@@@@@@@@@@@@@......@@@@@@@....@@.............@@@@@...@@@@@@@@@.....@@@@@@@@@@@....@
@@@@@@.....@@@@@@@@@@@@@@@@@@..........@@@@....@@............@@@@@@...@@@@@@@@@.....@@@@@@@@@@.....@
@@@@@@.....@@@@@@@@@@@@@@@@@@.................................@@@@@...@@@@@@@@@@@@......@@@@.......@
@@@@@@.....@@@@@@@@@@@@@@@@@@...@@@...........................@@@@....@@@@@@@@@@@@......@@@@.......@
@@@@@@.....@@@@@@@@@@@@@@@@@@...@@@@@@..............@@@@@@@...........@@@@@@@@@@@@......@@@@.......@
@@@@@@......@@@@@@@@@@@@@@@@@...@@..@@@@@....@....@@@@@@@@@@.....@....@@@@@@@@@@@@......@@@@.......@
@@@@@@......@@@@@@@@@@@@@@@@@.........@@@@@.@@...@@@@@@@@@@@@..@@@@@@.@@@@@@@@@@@@.................@
@@@@@@......@@@@@@@@@@@@@@@@@...........@@..@....@..@@@@@..@@@@@@@@@..@@@@@@@@@@@@.................@
@@@@@@......@@@@@@@@@@@@@@@@@@..............@....@..@@@@@..@@@@@@@@...@@@@@@@@@@@@................@@
@@@@@@......@@@@@@@@@@@@@@@@@@@............@@....@..@@@@...@@@@@@@@...@@@@@@@@@...................@@
@@@@@@@.....@@@@@@@@@@@@@@@@@@@@@@.........@..............@@@@@@@....@@@@@@@@@@...................@@
@@@@@@@......@@@@@@@@@@@@@@@@@@@@@@@@@....@@.............@@@.........@@@@@@@@@....@@@@@..........@@@
@@@@@@@......@@@@@@@@@@@@@@@@@@@@@@@@@@@..@............@@@@..........@@@@@@@@@...@@@@@@@@@.......@@@
@@@@@@@......@@@@@@@@@@@@@@@@@@@@@@@@@@@@@@.........................@@@@@@@@@...@@@@@@@@@@@@.....@@@
@@@@@@@......@@@@@@@@@@@@@@@@@@@@@@@@@@@@@..........................@@@@@@@@....@@@@@@@@@@@@@@..@@@@
@@@@@@@@.....@@@@@@@@@@@@@@@@@@@@@@@@@@@@@...........................@@@@@@@....@@@@@@@@@@@@@@@@@@@@
@@@@@@@@......@@@@@@@@@@@@@@@@@@@@@@@@@@@........................@....@@@@@@....@@@@@@@@@@@@@@@@@@@@
@@@@@@@@.......@@@@@@@@@@@@@@@@@@@@@@@@@@@@@@...................@@@....@@@@.....@@@@@@@@@@@@@@@@@@@@
@@@@@@@@.......@@@@@@@@@@@@@@@@@@@@@@@@@@@@@@@@@...............@@@@@.....@@......@@@@@@@@@@@@@@@@@@@
@@@@@@@@@.......@@@@@@@@@@@@@@@@@@@@@@@@@@@@@@@@@@...........@@@@@@@@........@@@@@@...@@@@@@@@@@@@@@
@@@@@@@@@........@@@@@@@@@@@@@@@@@@@@@@@@@@@@@@@@@......@...@@@@@@@@@@@......@@@@@.....@@@@@@@@@@@@@
@@@@@@@@@@........@@@@@@@@@@@@@@@@@@@@@@@@@@@@@@@@@@@@@@@..@@@@@@@@@@@@@@.............@@@@@@@@@@@@@@
@@@@@@@@@@@........@@@@@@@@@@@@@@@@@@@@@@@@@@@@@@@@@@@@@@...@@@@@@@@@@@@@@@@@........@@@@@@@@@@@@@@@
@@@@@@@@@@@@........@@@@@@@@@@@@@@@@@@@@@@@@@@@@@@@@@@@@@@...@@@@@@@@@@@@@@@@@@.....@@@@@@@@@@@@@@@@
@@@@@@@@@@@@.........@@@@@@@@@@@@@@@@@@@@@@@@@@@@@@@@@@@@@....@@@@@@@@@@@@@@@@@@@..@@@@@@@@@@@@@@@@@
@@@@@@@@@@@@@..........@@@@.@@@@@@@@@@@@@@@@@@@@@@@@@@@@@@....@@@@@@@@@@@@@@@@@@@@@@@@@@@@@@@@@@@@@@
@@@@@@@@@@@@@@...........@@......@@@@@@@@@@@@@@@@@@@@@@@@@....@@@@@@@@@@@@@@@@@@@@@@@@@@@@@@@@@@@@@@
@@@@@@@@@@@@@@@.....................@@@@@@@@@@@@@@@@@@@@@@....@@@@@@@@@@@@@@@@@@@@@@@@@@@@@@@@@@@@@@
@@@@@@@@@@@@@@@@........................@@..@@@@@@@@@@@@@@....@@@@@@@@@@@@@@@@@@@@@@@@@@@@@@@@@@@@@@
@@@@@@@@@@@@@@@@@...........................@@@@@@@@@@@@@@....@@@@@@@@@@@@@@@@@@@@@@@@@@@@@@@@@@@@@@
@@@@@@@@@@@@@@@@@@@............@@@..........@@@@@@@@@@@@@.....@@@@@@@@@@@@@@@@@@@@@@@@@@@@@@@@@@@@@@
@@@@@@@@@@@@@@@@@@@@........@@@@@@..........@@@@@@@@@@@@.....@@@@@@@@@@@@@@@@@@@@@@@@@@@@@@@@@@@@@@@
@@@@@@@@@@@@@@@@@@@@@........@@@@@@.........@@@@@@@@@@......@@@@@@@@@@@@@@@@@@@@@@@@@@@@@@@@@@@@@@@@
@@@@@@@@@@@@@@@@@@@@@@........@@@@@@@@.....................@@@@@@@@@@@@@@@@@@@@@@@@@@@@@@@@@@@@@@@@@
@@@@@@@@@@@@@@@@@@@@@@@....@....@@@@@@..@................@@@@@@@@@@@@@@@@@@@@@@@@@@@@@@@@@@@@@@@@@@@
@@@@@@@@@@@@@@@@@@@@@@@...@@@..@@@@@@@.@@@...........@@@@@@@@@@@@@@@@@@@@@@@@@@@@@@@@@@@@@@@@@@@@@@@
@@@@@@@@@@@@@@@@@@@..@....@@..@@@@@@@@.@@@@.......@@@@@@@@@@@@@@@@@@@@@@@@@@@@@@@@@@@@@@@@@@@@@@@@@@
@@@@@@@@@@@@@@@@@@.........@@@@@@@@@@@@@@@...@@@@@@@@@@@@@@@@@@@@@@@@@@@@@@@@@@@@@@@@@@@@@@@@@@@@@@@
@@@@@@@@@@@@@@@@@..............@@@@@@@@@@@...@@@@@@@@@@@@@@@@@@@@@@@@@@@@@@@@@@@@@@@@@@@@@@@@@@@@@@@
@@@@@@@@@@@@@@@@@@@................@@@@@@....@@@@@@@@@@@@@@@@@@@@@@@@@@@@@@@@@@@@@@@@@@@@@@@@@@@@@@@
@@@@@@@@@@@@@@@@@@@@@@...............@@@@....@@@@@@@@@@@@@@@@@@@@@@@@@@@@@@@@@@@@@@@@@@@@@@@@@@@@@@@
@@@@@@@@@@@@@@@@@@@@@@@@@...............@....@@@@@@@@@@@@@@@@@@@@@@@@@@@@@@@@@@@@@@@@@@@@@@@@@@@@@@@
@@@@@@@@@@@@@@@@@@@@@@@@@@@@@................@@@@@@@@@@@@@@@@@@@@@@@@@@@@@@@@@@@@@@@@@@@@@@@@@@@@@@@
@@@@@@@@@@@@@@@@@@@@@@@@@@@@@@@@@@@@@@@@@@@@@@@@@@@@@@@@@@@@@@@@@@@@@@@@@@@@@@@@@@@@@@@@@@@@@@@@@@@@
