type octile
height 87
width 87
map
@@@@@@@@@@@@@@@@@@@@@@@@@@@@@@@@@@@@@@@@@@@@@@@@@@@@@@@@@@@@@@@@@@@@@@@@@@@@@@@@@@@@@@@
@.....................................................................................@
@.....................................................................................@
@..@@@@@@@@@@@@@@@@@@@@@@@@@@@@@@@@@@@@@@..@@@@@@@@@@@@@@@@@@@@@@@@@@@@@@@@@@@@@@@@@..@
@..@@@@@@@@@@@@@@@@@@@@@@@@@@@@@@@@@@@@@@..@@@@@@@@@@@@@@@@@@@@@@@@@@@@@@@@@@@@@@@@@..@
@..@@.............................................................................@@..@
@..@@.............................................................................@@..@
@..@@.............................................................................@@..@
@..@@....................................SS.......................................@@..@
@..@@....................................SS.......................................@@..@
@..@@.............................................................................@@..@
@..@@.............................................................................@@..@
@..@@.............................................................................@@..@
@..@@.............................................................................@@..@
@..@@.............................................................................@@..@
@..@@.............................................................................@@..@
@..@@.............................................................................@@..@
@..@@.............................................................................@@..@
@..@@.............................................................................@@..@
@..@@.............................................................................@@..@
@..@@.............................................................................@@..@
@..@@.............................................................................@@..@
@..@@.............................................................................@@..@
@..@@.............................................................................@@..@
@..@@.............................................................................@@..@
@..@@.............................................................................@@..@
@..@@.............................................................................@@..@
@..@@.............................................................................@@..@
@..@@.............................................................................@@..@
@..@@.............................................................................@@..@
@..@@.............................................................................@@..@
@..@@.............................................................................@@..@
@..@@.............................................................................@@..@
@..@@.............................................................................@@..@
@..@@.............................................................................@@..@
@..@@.............................................................................@@..@
@..@@.............................................................................@@..@
@..@@.............................................................................@@..@
@..@@.............................................................................@@..@
@..@@.............................................................................@@..@
@..@@.............................................................................@@..@
@..@@.............................................................................@@..@
@..@@.............................................................................@@..@
@..@@.............................................................................@@..@
@..@@.............................................................................@@..@
@..@@.............................................................................@@..@
@..@@.............................................................................@@..@
@..@@.............................................................................@@..@
@..@@.............................................................................@@..@
@..@@.............................................................................@@..@
@..@@.............................................................................@@..@
@..@@.............................................................................@@..@
@..@@.............................................................................@@..@
@..@@.............................................................................@@..@
@..@@.............................................................................@@..@
@..@@.............................................................................@@..@
@..@@.............................................................................@@..@
@..@@.............................................................................@@..@
@..@@.............................................................................@@..@
@..@@.............................................................................@@..@
@..@@.............................................................................@@..@
@..@@.............................................................................@@..@
@..@@.............................................................................@@..@
@..@@.............................................................................@@..@
@..@@.............................................................................@@..@
@..@@.............................................................................@@..@
@..@@.............................................................................@@..@
@..@@.............................................................................@@..@
@..@@.............................................................................@@..@
@..@@.............................................................................@@..@
@..@@.............................................................................@@..@
@..@@.............................................................................@@..@
@..@@.............................................................................@@..@
@..@@.............................................................................@@..@
@..@@.............................................................................@@..@
@..@@.............................................................................@@..@
@..@@.............................................................................@@..@
@..@@.............................................................................@@..@
@..@@.............................................................................@@..@
@..@@.............................................................................@@..@
@..@@.............................................................................@@..@
@..@@.............................................................................@@..@
@..@@@@@@@@@@@@@@@@@@@@@@@@@@@@@@@@@@@@@@@@@@@@@@@@@@@@@@@@@@@@@@@@@@@@@@@@@@@@@@@@@..@
@..@@@@@@@@@@@@@@@@@@@@@@@@@@@@@@@@@@@@@@@@@@@@@@@@@@@@@@@@@@@@@@@@@@@@@@@@@@@@@@@@@..@
@........................................SS...........................................@
@........................................SS...........................................@
@@@@@@@@@@@@@@@@@@@@@@@@@@@@@@@@@@@@@@@@@@@@@@@@@@@@@@@@@@@@@@@@@@@@@@@@@@@@@@@@@@@@@@@
