type octile
height 25
width 25
map
@@@@@@@@@@@@@@@@@@@@@@@@@
@@@@@@@@@@@@@@@@@@@@@@@@@
@@@@@@@@@@@@@@@@@@@@@@@@@
@@@@@@@@@@@@@@@@@@@@@@@@@
@@@@@@@@@@@@@@@@@@@@@@@@@
@@@@@@@@@@@@@@@@@@@@@@@@@
@@@@@@@@@@@@@@@@@@@@@@@@@
@@@@@@@@TTTTTTTTTT@@@@@@@
@@@@@@@@T........T@@@@@@@
@@@@@@@@T........T@@@@@@@
@@@@@@@@T........T@@@@@@@
@@@@@@@@T........T@@@@@@@
@@@@@@@@T.T......T@@@@@@@
@@@@@@@@T.T......T@@@@@@@
@@@@@@@@T.T......T@@@@@@@
@@@@@@@@T.T....T.T@@@@@@@
@@@@@@@@TTTTTTTTTT@@@@@@@
@@@@@@@@@@@@@@@@@@@@@@@@@
@@@@@@@@@@@@@@@@@@@@@@@@@
@@@@@@@@@@@@@@@@@@@@@@@@@
@@@@@@@@@@@@@@@@@@@@@@@@@
@@@@@@@@@@@@@@@@@@@@@@@@@
@@@@@@@@@@@@@@@@@@@@@@@@@
@@@@@@@@@@@@@@@@@@@@@@@@@
@@@@@@@@@@@@@@@@@@@@@@@@@
