type octile
height 10
width 12
map
@@@@@@@@@@@@
@..........@
@..@@@@@@..@
@..@.......@
@..@....@..@
@..@....@..@
@.......@..@
@..@@@@@@..@
@..........@
@@@@@@@@@@@@
