type octile
height 6
width 11
map
@@@@@.@@@@@
@.........@
@@.@@@@@@.@
@...@.....@
@...@.....@
@@@@@@@@@@@
