type octile
height 50
width 50
map
@@@@@@@@@@@@@@@@@@@@@@@@@@@@@@@@@@@@@@@@@@@@@@@@@@
@................................................@
@................................................@
@................................................@
@................................................@
@................................................@
@................................................@
@................................................@
@.....@@@@@@@@@@@@@@@@@@@@@.....@@@@@@...........@
@.....@...................@.....@....@...........@
@.....@...................@.....@....@...........@
@.....@...................@.....@....@...........@
@................................................@
@................................................@
@................................................@
@................................................@
@................................................@
@................................................@
@................................................@
@................................................@
@................................................@
@................................................@
@................................................@
@................................................@
@................................................@
@................................................@
@................................................@
@................................................@
@................................................@
@................................................@
@................................................@
@................................................@
@................................................@
@................................................@
@................................................@
@................................................@
@................................................@
@................................................@
@................................................@
@................................................@
@................................................@
@................................................@
@................................................@
@................................................@
@................................................@
@................................................@
@................................................@
@................................................@
@................................................@
@@@@@@@@@@@@@@@@@@@@@@@@@@@@@@@@@@@@@@@@@@@@@@@@@@
