type octile
height 23
width 41
map
@@@@@@@@@@@@@@@@@@@@@@@@@@@@@@@@@@@@@@@@@
@.................@@@@@@@@@@@@@@@@@@@@@@@
@.................@@@@@@@@@@@........@@@@
@...@@@@@@@@@@....@@@@@@@@@@@........@@@@
@...@@@@@@@@@@....@@@@@@@@@@@........@@@@
@...@@@@@@@@@@.......................@@@@
@...@@@@@@@@@@.......................@@@@
@...@@@@@@@@@@....@@@@@@@@@@@........@@@@
@...@@@@@@@@@@....@@@@@@@@@@@........@@@@
@.................@@@@@@@@@@@........@@@@
@.................@@@@@@@@@@@@@@..@@@@@@@
@@@@@@@@..@@@@@@@@@@@@@@@@@@@@@@..@@@@@@@
@.................@@@@@@@@@@@@@@..@@@@@@@
@.................@@@@@@@@@@@........@@@@
@...@@@@@@@@@@....@@@@@@@@@@@........@@@@
@...@@@@@@@@@@....@@@@@@@@@@@........@@@@
@...@@@@@@@@@@.......................@@@@
@...@@@@@@@@@@.......................@@@@
@...@@@@@@@@@@....@@@@@@@@@@@........@@@@
@...@@@@@@@@@@....@@@@@@@@@@@........@@@@
@.................@@@@@@@@@@@........@@@@
@.................@@@@@@@@@@@@@@@@@@@@@@@
@@@@@@@@@@@@@@@@@@@@@@@@@@@@@@@@@@@@@@@@@
