type octile
height 41
width 41
map
@@@@@@@@@@@@@@@@@@@@@@@@@@@@@@@@@@@@@@@@@
@.......................................@
@.......................................@
@.......................................@
@.......................................@
@....@@@@@@@@@@@@@@@@@@@@@@@@@@@@@@@....@
@....@..............@..............@....@
@....@..............@..............@....@
@....@..............@..............@....@
@....@..............@..............@....@
@....@....@@@@@@@@..@..@@@@@@@@....@....@
@....@....@.........@.........@....@....@
@....@....@.........@.........@....@....@
@....@....@.........@.........@....@....@
@....@....@.........@.........@....@....@
@....@....@....@@@@@@@@@@@....@....@....@
@....@....@....@....@....@....@....@....@
@....@....@....@....@....@....@....@....@
@....@....@....@....@....@....@....@....@
@.........@.........@.........@.........@
@.........@...................@.........@
@.........@.........@.........@.........@
@....@....@....@....@....@....@....@....@
@....@....@....@....@....@....@....@....@
@....@....@....@....@....@....@....@....@
@....@....@....@@@@@@@@@@@....@....@....@
@....@....@.........@.........@....@....@
@....@....@.........@.........@....@....@
@....@....@.........@.........@....@....@
@....@....@.........@.........@....@....@
@....@....@@@@@@@@..@..@@@@@@@@....@....@
@....@..............@..............@....@
@....@..............@..............@....@
@....@..............@..............@....@
@....@..............@..............@....@
@....@@@@@@@@@@@@@@@@@@@@@@@@@@@@@@@....@
@.......................................@
@.......................................@
@.......................................@
@.......................................@
@@@@@@@@@@@@@@@@@@@@@@@@@@@@@@@@@@@@@@@@@
