type octile
height 31
width 43
map
TTTTTTWWWWWWWWWWWWWWWWWWWWWWWWWWWWWWWTTTTTT
TTTTTTWW............WWW............WWTTTTTT
TTTTTTWW.WWWW.WWWWW.WWW.WWWWW.WWWW.WWTTTTTT
TTTTTTWWSWWWW.WWWWW.WWW.WWWWW.WWWWSWWTTTTTT
TTTTTTWW.WWWW.WWWWW.WWW.WWWWW.WWWW.WWTTTTTT
TTTTTTWW...........................WWTTTTTT
TTTTTTWW.WWWW.WW.WWWWWWWWW.WW.WWWW.WWTTTTTT
TTTTTTWW.WWWW.WW.WWWWWWWWW.WW.WWWW.WWTTTTTT
TTTTTTWW......WW....WWW....WW......WWTTTTTT
TTTTTTWWWWWWW.WWWWW.WWW.WWWWW.WWWWWWWTTTTTT
TTTTTTWWWWWWW.WWWWW.WWW.WWWWW.WWWWWWWTTTTTT
TTTTTTWWWWWWW.WW...........WW.WWWWWWWTTTTTT
TTTTTTWWWWWWW.WW.WWWWSWWWW.WW.WWWWWWWTTTTTT
TTTTTTWWWWWWW.WW.WWWWSWWWW.WW.WWWWWWWTTTTTT
TTTTTT...........WWWWSWWWW...........TTTTTT
TTTTTTWWWWWWW.WW.WWWWSWWWW.WW.WWWWWWWTTTTTT
TTTTTTWWWWWWW.WW.WWWWWWWWW.WW.WWWWWWWTTTTTT
TTTTTTWWWWWWW.WW...........WW.WWWWWWWTTTTTT
TTTTTTWWWWWWW.WW.WWWWWWWWW.WW.WWWWWWWTTTTTT
TTTTTTWWWWWWW.WW.WWWWWWWWW.WW.WWWWWWWTTTTTT
TTTTTTWW............WWW............WWTTTTTT
TTTTTTWW.WWWW.WWWWW.WWW.WWWWW.WWWW.WWTTTTTT
TTTTTTWW.WWWW.WWWWW.WWW.WWWWW.WWWW.WWTTTTTT
TTTTTTWWS..WW.................WW..SWWTTTTTT
TTTTTTWWWW.WW.WW.WWWWWWWWW.WW.WW.WWWWTTTTTT
TTTTTTWWWW.WW.WW.WWWWWWWWW.WW.WW.WWWWTTTTTT
TTTTTTWW......WW....WWW....WW......WWTTTTTT
TTTTTTWW.WWWWWWWWWW.WWW.WWWWWWWWWW.WWTTTTTT
TTTTTTWW.WWWWWWWWWW.WWW.WWWWWWWWWW.WWTTTTTT
TTTTTTWW...........................WWTTTTTT
TTTTTTWWWWWWWWWWWWWWWWWWWWWWWWWWWWWWWTTTTTT
