type octile
height 8
width 30
map
@@@@@@@@@@@@@@@@@@@@@@@@@@@@@@
@.....@@@@@@@@@@@@@@@@@@.....@
@.....@@@@@@@@@@@@@@@@@@.....@
@.....SSSSSSSSSSSSSSSSSS.....@
@.....SSSSSSSSSSSSSSSSSS.....@
@.....@@@@@@@@@@@@@@@@@@.....@
@.....@@@@@@@@@@@@@@@@@@.....@
@@@@@@@@@@@@@@@@@@@@@@@@@@@@@@
