type octile
height 8
width 30
map
@@@@@@@@@@@@@@@@@@@@@@@@@@@@@@
@SSSSSSSSSSSSSSSSSSSSSSSSSSSS@
@S@@@@@@@@@@@@@@@@@@@@@@@@@@S@
@S@@@@@@@@@@@@@@@@@@@@@@@@@@S@
@S@@@@@@@@@@@@@@@@@@@@@@@@@@S@
@S@@@@@@@@@@@@@@@@@@@@@@@@@@S@
@SSSSSSSSSSSSSSSSSSSSSSSSSSSS@
@@@@@@@@@@@@@@@@@@@@@@@@@@@@@@
