type octile
height 32
width 32
map
@@@@@@@@@@@@@@@@@@@@@@@@@@@@@@@@
@SSSSSSSSSSSSSS@@SSSSSSSSSSSSSS@
@SSSSSSSSSSSSSS@@SSSSSSSSSSSSSS@
@SSSSSSSSSSSSSS@@SSSSSSSSSSSSSS@
@SSSSSSSSSSSSSS@@SSSSSSSSSSSSSS@
@SSSSSSSSSSSSSS@@SSSSSSSSSSSSSS@
@SSSSSSSSSSSSSS@@SSSSSSSSSSSSSS@
@SSSSSSSSSSSSSS@@SSSSSSSSSSSSSS@
@SSSSSSSSSSSSSS@@SSSSSSSSSSSSSS@
@SSSSSSSSSSSSSS@@SSSSSSSSSSSSSS@
@SSSSSSSSSSSSSS@@SSSSSSSSSSSSSS@
@SSSSSSSSSSSSSS@@SSSSSSSSSSSSSS@
@SSSSSS@@SSSSSS@@SSS@SS@@SSSSSS@
@S.....S@SSSS@SSSSSSSSS@S.....S@
@S.....S@SSSSSS@SS@SSSS@S.....S@
@S.....S@SSSSS@SSSS@SSS@S.....S@
@S.....S@SSSSSSS@SSSSSS@S.....S@
@S.....S@SSSSS@SSS@SSSS@S.....S@
@S.....S@SSS@SSSSSSSSSS@S.....S@
@SSSSSS@@SSSSSS@@SSS@SS@@SSSSSS@
@SSSSSSSSSSSSSS@@SSSSSSSSSSSSSS@
@SSSSSSSSSSSSSS@@SSSSSSSSSSSSSS@
@SSSSSSSSSSSSSS@@SSSSSSSSSSSSSS@
@SSSSSSSSSSSSSS@@SSSSSSSSSSSSSS@
@SSSSSSSSSSSSSS@@SSSSSSSSSSSSSS@
@SSSSSSSSSSSSSS@@SSSSSSSSSSSSSS@
@SSSSSSSSSSSSSS@@SSSSSSSSSSSSSS@
@SSSSSSSSSSSSSS@@SSSSSSSSSSSSSS@
@SSSSSSSSSSSSSS@@SSSSSSSSSSSSSS@
@SSSSSSSSSSSSSS@@SSSSSSSSSSSSSS@
@SSSSSSSSSSSSSS@@SSSSSSSSSSSSSS@
@@@@@@@@@@@@@@@@@@@@@@@@@@@@@@@@
