type octile
height 32
width 32
map
@@@@@@@@@@@@@@@@@@@@@@@@@@@@@@@@
@SSSSSSSSSSSSSS@@SSSSSSSSSSSSSS@
@SSSSSSSSSSSSSS@@SSSSSSSSSSSSSS@
@SSSSSSSSSSSSSS@@SSSSSSSSSSSSSS@
@SSSSSSSSSSSSSS@@SSSSSSSSSSSSSS@
@SSSSSSSSSSSSSS@@SSSSSSSSSSSSSS@
@SSSSSSSSSSSSSS@@SSSSSSSSSSSSSS@
@SSSSSSSSSSSSSS@@SSSSSSSSSSSSSS@
@SSSSSSSSSSSSSS@@SSSSSSSSSSSSSS@
@SSSSSSSSSSSSSS@@SSSSSSSSSSSSSS@
@SSSSSSSSSSSSSS@@SSSSSSSSSSSSSS@
@SSSSSSSSSSSSSS@@SSSSSSSSSSSSSS@
@SSSSSSSSSSSSSS@@SSS@SSSSSSSSSS@
@S.....@SSSSS@SSSSSSSSS@S.....S@
@S.....SSSS@SSS@SS@SS@SSS.....S@
@S.....SS@SSSS@SSSS@SSSSS.....S@
@S.....SSSS@SSSS@SSSSS@SS.....S@
@S.....S@SSSSS@SSS@SSSSSS.....S@
@S.....SSSSS@SSSSSSSSSSSS.....S@
@SSSSSSS@SSSSSS@@SSS@SSSSSSSSSS@
@SSSSSSSSSSSSSS@@SSSSSSSSSSSSSS@
@SSSSSSSSSSSSSS@@SSSSSSSSSSSSSS@
@SSSSSSSSSSSSSS@@SSSSSSSSSSSSSS@
@SSSSSSSSSSSSSS@@SSSSSSSSSSSSSS@
@SSSSSSSSSSSSSS@@SSSSSSSSSSSSSS@
@SSSSSSSSSSSSSS@@SSSSSSSSSSSSSS@
@SSSSSSSSSSSSSS@@SSSSSSSSSSSSSS@
@SSSSSSSSSSSSSS@@SSSSSSSSSSSSSS@
@SSSSSSSSSSSSSS@@SSSSSSSSSSSSSS@
@SSSSSSSSSSSSSS@@SSSSSSSSSSSSSS@
@SSSSSSSSSSSSSS@@SSSSSSSSSSSSSS@
@@@@@@@@@@@@@@@@@@@@@@@@@@@@@@@@
