type octile
height 32
width 32
map
@@@@@@@@@@@@@@@@@@@@@@@@@@@@@@@@
@SSSSSSSSSSSSSSSSSSSSSSSSSSSSSS@
@SSSSSSSSSSSSSSSSSSSSSSSSSSSSSS@
@SSSSSSSSSSSSSSSSSSSSSSSSSSSSSS@
@SSSSSSSSSSSSSSSSSSSSSSSSSSSSSS@
@SSSSSSSSSSSSSSSSSSSSSSSSSSSSSS@
@SSSSSSSSSSSSSSSSSSSSSSSSSSSSSS@
@SSSSSSSSSSSSSSSSSSSSSSSSSSSSSS@
@SSSSSSSSSSSSSSSSSSSSSSSSSSSSSS@
@SSSSSSSSSSSSSSSSSSSSSSSSSSSSSS@
@SSSSSSSSSSSSSSSSSSSSSSSSSSSSSS@
@SSSSSSSSSSSSSSSSSSSSSSSSSSSSSS@
@SSSSSSSSSSSSSSSSSSSSSSSSSSSSSS@
@SSSSSSSSSSSSSSSSSSSSSSSSSSSSSS@
@SSSSSSSSSSSSSSSSSSSSSSSSSSSSSS@
@SSSSSSSSSSSSSSSSSSSSSSSSSSSSSS@
@SSSSSSSSSSSSSS@@SSSSSSSSSSSSSS@
@SSSSSSSSSSSSSS@@SSSSSSSSSSSSSS@
@SSSSSSSSSSSSSS@@SSSSSSSSSSSSSS@
@SSSSSSSSSSSSSS@@SSSSSSSSSSSSSS@
@SSSSSSSSSSSSSS@@SSSSSSSSSSSSSS@
@SSSSSSSSSSSSSS@@SSSSSSSSSSSSSS@
@SSSSSSSSSSSSSS@@SSSSSSSSSSSSSS@
@SSSSSSSSSSSSSS@@SSSSSSSSSSSSSS@
@SSSSSSSSSSSSSS@@SSSSSSSSSSSSSS@
@..............@@..............@
@..............@@..............@
@..............@@..............@
@..............@@..............@
@..............@@..............@
@..............@@..............@
@@@@@@@@@@@@@@@@@@@@@@@@@@@@@@@@
