type octile
height 12
width 7
map
@@@@@@@
@.....@
@.....@
@@@.@@@
@@@.@@@
@@@.@@@
@@@.@@@
@@@.@@@
@@@.@@@
@.....@
@.....@
@@@@@@@
